ㄱㅏ	G A
ㄱㅏㄱㅏㄱ	G A G A G
ㄱㅏㄱㅜㅇㅔㄷㅐㅎㅏㄴ	G A G U E D AE A N
ㄱㅏㄴㅏㅁ	G A N A M
ㄱㅏㄴㅡㄴㅈㅣㅂㅏㅇ	G A N EU N J I B A NG
ㄱㅏㄷㅡㄹㅇㅡㄴㅇㅣㅅㅏㅇㅇㅡㄴ	G A D EU R EU N I S A NG EU N
ㄱㅏㄷㅡㄹㅇㅣㅈㅣ	G A D EU R I J I
ㄱㅏㄹㅡㄹㅂㅏㄷ	G A R EU L B A D
ㄱㅏㅅㅏㅅㅣㅂㅇㅣ	G A S A S I B I
ㄱㅏㅅㅣㄹ	G A S I L
ㄱㅏㅇㅔㄷㅐㅎㅏㄴㅅㅏ	G A E D AE A N S A
ㄱㅏㅇㅗㄴㅡㄴㅇㅣㅅㅣㅂㅅㅏㅁㅇㅣㄹ	G A O N EU N I S I p S A M I L
ㄱㅏㅇㅣㅅㅣㅂㅅㅏㅁ	G A I S I p S A M
ㄱㅏㅇㅣㄹㅂㅜㅇㅔㅅㅓ	G A I L B U E S EO
ㄱㅏㅇㅣㅆㄷㅏㄱㅗ	G A I t D A G O
ㄱㅏㅈㅓㅇㅂㅜㅇㅢ	G A J EO NG B U euI
ㄱㅏㅈㅣㄷㅗㅈㅏㅇㅢ	G A J I D O J A euI
ㄱㅏㅈㅣㅇㅣㅅㅏㅇ	G A J I I S A NG
ㄱㅏㅎㅏㄴㅡㄴㄱㅓㅅㅇㅡㄴ	G A A N EU N G EO S EU N
ㄱㅏㅎㅏㄴㄱㅓㅅㅇㅡㄴㅈㅣㄴㅏㄴㅎㅐㅅㅣㅂ	G A A N G EO S EU N J I N A N AE S I B
ㄱㅏㅎㅏㄹㄱㅓㅅㅇㅣㄹㅏㄱㅗㅇㅣ	G A A L G EO S I R A G O I
ㄱㅏㄱㅇㅣㄹㅏㄱㅗㅁㅏㄹㅎㅏㄱㅗㄱㅡㄹㅓㄴㅏ	G A G I R A G O M A R H A G O G EU R EO N A
ㄱㅏㄱㅇㅣㅈㅓㅁㅇㅣㄹ	G A G I J EO M I R
ㄱㅏㄴㅇㅔㅅㅓ	G A N E S EO
ㄱㅏㄴㅇㅡㄹㅁㅏㄹㅕㄴ	G A N EU L M A R iEO N
ㄱㅏㄴㅇㅣㅂㅐㄱㅇㅣㅅㅣㅂ	G A N I B AE G I S I M
ㄱㅏㄴㅇㅣㄹㅊㅓㄴㅇㅣㄹㅂㅐㄱ	G A N I L CHh EO N I L B AE k
ㄱㅏㅌㅇㅡㄴㅇㅣㄹ	G A Th EU N I L
ㄱㅐㅂㅏㄹㅇㅣㅅㅏㅅㅣㄹ	G AE B A R I S A S I L
ㄱㅐㅅㅏㅇㅓㅂ	G AE S A EO B
ㄱㅐㅅㅓㄴㅎㅏㄱㅣㅇㅟㅎㅐ	G AE S EO N A G I UE AE
ㄱㅐㅇㅣㅂㅎㅏㄴㅅㅏㅅㅣㄹㅇㅡㄹㅂㅏㄺ	G AE I Ph A N S A S I R EU L B A Kh
ㄱㅐㅎㅏㄴㅡㄴㄱㅓㅅ	G AE A N EU N G EO t
ㄱㅓㄴㅏㅅㅏ	G EO N A S A
ㄱㅓㄹㅣㄱㅏㅅㅏ	G EO R I G A S A
ㄱㅓㄴㅅㅓㄹㅇㅡㄹㄱㅏ	G EO N S EO R EU L G A
ㄱㅓㄴㅇㅡㄹㅁㅏㄹㅕㄴ	G EO N EU L M A R iEO N
ㄱㅓㄹ	G EO R
ㄱㅓㅁㅊㅏㄹㅇㅡㄴㅇㅣㄹㅂㅜ	G EO M CHh A R EU N I L B U
ㄱㅓㅁㅊㅏㄹㅇㅣㅈㅓㄱ	G EO M CHh A R I J EO k
ㄱㅓㅅㅇㅡㄹㅗㅂㅗㄱㅗㅇㅣㅂㅓㄴ	G EO S EU R O B O G O I B EO N
ㄱㅓㅅㅇㅡㄹㅗㅅㅣㅂㅇㅣㄹㅇㅣㄹ	G EO S EU R O S I B I R I R
ㄱㅓㅅㅇㅡㄴㅇㅏㄴㅣㄷㅏㄱㅗ	G EO S EU N A N I D A G O
ㄱㅓㅅㅇㅡㄹㅂㅗㅇㅕ	G EO S EU L B O iEO
ㄱㅓㅅㅇㅣㄹㅏㄱㅗㄱㅏㅇ	G EO S I R A G O G A NG
ㄱㅓㅅㅇㅣㄹㅏㄴㅡㄴㅅㅏㅅㅣㄹㅇㅡㄹ	G EO S I R A N EU N S A S I R EU R
ㄱㅓㅅㅇㅣㅅㅣㅂㅇㅣㅇㅣㄹ	G EO S I S I B I I R
ㄱㅔㅇㅣㅁㅣ	G E I M I
ㄱㅔㅎㅏㄱㅗㅎㅏㄴ	G E A G O A N
ㄱㅕㄱ	G iEO G
ㄱㅕㄴㅇㅡㄹㄱㅏㅈ	G iEO N EU L G A t
ㄱㅕㅇㄱㅣㄱㅗㄱㅏ	G iEO NG G I G O G A
ㄱㅕㅇㄱㅣㅅㅣㅅㅓㄹㅇㅡㄹ	G iEO NG G I S I S EO R EU R
ㄱㅕㅇㄱㅣㅈㅣㅅㅏㄱㅏ	G iEO NG G I J I S A G A
ㄱㅕㅇㅇㅜㅇㅣㄹㅡㄹ	G iEO NG U I R EU L
ㄱㅖㅈㅏㄴㅡㄴㅈㅓㅇ	G iE J A N EU N J EO NG
ㄱㅗㄱㅏㄱㅜ	G O G A G U
ㄱㅗㄱㅡㄹㅓ	G O G EU R EO
ㄱㅗㄱㅣㅇㅔㄷㅐㅎㅐ	G O G I E D AE AE
ㄱㅗㄴㅡㄴㅇㅗㅎㅜ	G O N EU N O U
ㄱㅗㅁㅏㄹㅇㅡㄹㄱㅓ	G O M A R EU L G EO
ㄱㅗㅅㅏㅇㅓㅂ	G O S A EO p
ㄱㅗㅅㅣㅈㅏㄱ	G O S I J A Kh
ㄱㅗㅇㅏㄴㅈㅓㄴㅎㅏㄴ	G O A N J EO N A N
ㄱㅗㅇㅣㅂㅜㅌㅓㅅㅏㅁㅇㅣㄹ	G O I B U Th EO S A M I L
ㄱㅗㅇㅣㅎㅜ	G O I U
ㄱㅗㅇㅣㅂ	Kh O I B
ㄱㅗㅇㅣㅆㄴㅡㄴㄷㅔㅇㅣ	G O I N N EU N D E I
ㄱㅗㅇㅣㅆㄴㅡㄴㅇㅣㄹㅇㅣㅇㅓㅆㄷㅏ	G O I N N EU N I R I EO t D A
ㄱㅗㅇㅣㅆㄷㅏㄱㅗㅈㅜㅈㅏㅇㅎㅏㅁㅕㄴㅅㅓㅇㅣ	Kh O I t D A G O J U J A NG H A M iEO N S EO I
ㄱㅗㅇㅣㅆㅇㅡㄴㅏㅅㅏㅅㅣㄹ	G O I S EU N A S A S I L
ㄱㅗㅈㅏㅅㅣㄴㅇㅣㅎㅏㄱㅗ	Kh O J A S I N I A G O
ㄱㅗㅈㅣㄷㅗㅈㅏㅇㅣㄴ	G O J I D O J A I N
ㄱㅗㅎㅏㄷㅗ	G O A D O
ㄱㅗㅎㅏㄴㅈㅓㅇ	G O A N J EO NG
ㄱㅗㅅㅇㅣㄹㅏㄷㅗ	G O S I R A D O
ㄱㅗㅇㅅㅏㄴㅏ	G O NG S A N A
ㄱㅗㅇㅅㅏㄹㅗㅇㅣㄹㅂㅜ	G O NG S A R O I L B U
ㄱㅗㅇㅅㅏㅇㅣㄹ	G O NG S A I L
ㄱㅗㅇㅎㅏㄴㅡㄴㅅㅏㅇㅓㅂ	G O NG H A N EU N S A EO p
ㄱㅘㅈㅓㅇㅇㅣㅈㅜㅇ	G oA J EO NG I J U NG
ㄱㅘㅎㅏㅁㅕㅇㅣㄱㅏㅇㅜㄴ	G oA A M iEO I G A U N
ㄱㅘㄴㄱㅖㅈㅏㄴㅡㄴㅅㅣㅅㅓㄹㅇㅣ	G oA N G iE J A N EU N S I S EO R I
ㄱㅘㄴㄱㅖㅈㅏㄴㅡㄴㅇㅣㅇㅔㄷㅐㅎㅐㅈㅓㅇ	G oA N G iE J A N EU N I E D AE AE J EO NG
ㄱㅘㄴㄱㅖㅈㅏㄷㅡㄹㅇㅔㄸㅏㄹㅡㅁㅕㄴ	G oA N G iE J A D EU R E D A R EU M iEO N
ㄱㅘㄴㄱㅖㅈㅏㅇㅘ	G oA N G iE J A oA
ㄱㅘㄴㅇㅡㄴㅇㅣㅇㅓ	G oA N EU N I EO
ㄱㅜㄱㅏㅅㅣㅂ	G U G A S I p
ㄱㅜㄴㅡㄴㅇㅣㅅㅣㅂㅇㅠㄱ	G U N EU N I S I B iU k
ㄱㅜㅅㅣㅂ	G U S I Ph
ㄱㅜㅅㅣㅂㅅㅏㅁㅏㄴㅇㅣㅊㅓㄴ	G U S I p S A M A N I CHh EO N
ㄱㅜㅅㅣㅂㅇㅣㄴㅕㄴㅇㅣㅅㅣㅂㅍㅏㄹ	G U S I B I N iEO N I S I p Ph A L
ㄱㅜㅅㅣㅂㅍㅏㄹ	G U S I p Ph A R
ㄱㅜㅇㅣㄹㅂㅜㅌㅓㄴㅡㄴ	G U I L B U Th EO N EU N
ㄱㅜㅇㅣㅂㅎㅏㄴㄱㅓㅅㅇㅡㄹㅗㅂㅏㄺ	G U I Ph A N G EO S EU R O B A Kh
ㄱㅜㅎㅏㄱㅗㅇㅣㅆㄴㅡㄴㄱㅓㅅㅇㅡㄴ	G U A G O I N N EU N G EO S EU N
ㄱㅜㅎㅏㄴㅡㄴㄱㅓㅅㅇㅡㄹ	G U A N EU N G EO S EU N
ㄱㅜㅎㅏㄴㄱㅓㅅ	G U A N G EO t
ㄱㅜㄱㄴㅐㅇㅔㅇㅣㅆㄴㅡㄴ	G U NG N AE E I N N EU N
ㄱㅜㄱㅇㅡㄴㅈㅣㄱㅡㅁ	G U G EU N J I G EU M
ㄱㅜㄱㅇㅣㅂㅜ	G U G I B U
ㄱㅜㄱㅇㅣㅈㅜ	G U G I J U
ㄱㅜㄴㅇㅡㄴㅇㅗㄴㅡㄴㅅㅣㅂㅅㅏㅇㅣㄹ	G U N EU N O N EU N S I p S A I L
ㄱㅜㄴㅇㅣㅅㅣㅂㅇㅣ	G U N I S I B I
ㄱㅡㄴㅡㄴㄱㅜㅅㅣㅂㅇㅣㄹㄴㅕㄴ	G EU N EU N G U S I B I N N iEO N
ㄱㅡㄴㅡㄴㅇㅣㄹ	G EU N EU N I N
ㄱㅡㄹㅓㄴㅏㅇㅏㅇㅣ	G EU R EO N A A I
ㄱㅡㄹㅓㄴㅏㅇㅣㄹㅇㅣㄹ	G EU R EO N A I R I L
ㄱㅡㄹㅣㄱㅗㄴㅡㄴ	G EU R I G O N EU N
ㄱㅡㄹㅣㅎㅏㅁㅕㄴㅅㅓ	G EU R I A M iEO N S EO
ㄱㅡㅁㅇㅡㄹㅇㅣㄴㅎㅏㅎㅏ	G EU M EU R I N A A
ㄱㅣㄱㅏㅅㅣㅂㅇㅣㄹ	G I G A S I B I R
ㄱㅣㄱㅏㄴㅇㅔㅇㅣㅇㅣㄱㅇㅡㄹㄴㅐ	G I G A N E I I G EU N N AE
ㄱㅣㄱㅏㄴㅇㅣㅅㅏㅁ	G I G A N I S A M
ㄱㅣㄱㅗㅇㅣㄹㅂㅗㄴ	G I G O I L B O N
ㄱㅣㄱㅜㅇㅔㄷㅐㅎㅐㅇㅣㅇㅠ	G I G U E D AE AE I iU
ㄱㅣㄱㅣㅇㅢ	G I G I euI
ㄱㅣㄴㅡㄴㅇㅣㄹㅂㅗㄴ	G I N EU N I L B O N
ㄱㅣㄷㅐㅎㅏㄴㅡㄴㄱㅓㅅㅇㅡㄴ	G I D AE A N EU N G EO S EU N
ㄱㅣㄷㅗㅎㅏㄴㅡㄴㄷㅡㅇ	G I D O A N EU N D EU NG
ㄱㅣㄹㅗㅂㅜㄴ	G I R O B U N
ㄱㅣㄹㅗㅎㅏㄴㅡㄴㅎㅏㄴㅍㅕㄴ	Kh I R O A N EU N A N Ph iEO N
ㄱㅣㄹㅗㄱㅇㅡㄹㅇㅣㄹ	G I R O G EU R I L
ㄱㅣㅅㅏㄷㅡㄹㅇㅡㄴ	G I S A D EU R EU N
ㄱㅣㅅㅣㄱㅣㄴㅡㄴㅇㅗ	G I S I G I N EU N O
ㄱㅣㅇㅓㅂㅇㅣㄴㅐ	G I EO B I N AE
ㄱㅣㅇㅔㄴㅡㄴㄴㅗ	G I E N EU N N O
ㄱㅣㅇㅔㅇㅣㄹㅡㄴ	G I E I R EU N
ㄱㅣㅇㅟㅎㅏㄴㅈㅓㄴ	G I UE A N J EO N
ㄱㅣㅇㅟㅎㅐㅈㅓㅇㅂㅜ	G I UE AE J EO NG B U
ㄱㅣㅇㅣㅈㅓㄴㅇㅔㄴㅡㄴ	G I I J EO N E N EU N
ㄱㅣㅈㅏㄹㅗㅎㅘㄹ	G I J A R O oA L
ㄱㅣㅈㅓㄱㅇㅡㄹㅗㅅㅓㄹ	G I J EO G EU R O S EO L
ㄱㅣㅈㅜㄴㅇㅡㄹㅗㅇㅗ	G I J U N EU R O O
ㄱㅣㅈㅣㄷㅗ	G I J I D O
ㄱㅣㅎㅏㄱㅣㅇㅓ	G I A G I EO
ㄱㅣㅎㅏㄹㄱㅓㅅㅇㅡㄹㅗㅂㅗㅇㅣㄴㄷㅏㅁㅕㄴㅅㅓㅇㅣㄱㅏㅌㅇㅡㄴ	G I A L G EO S EU R O B O I N D A M iEO N S EO I G A Th EU N
ㄲㅏㅈㅣㄱㅏㄱㅕㄱㅇㅡㄹㅇㅣㄴㅎㅏ	G A J I G A G iEO G EU R I N A
ㄲㅏㅈㅣㄷㅗㅅㅏ	G A J I D O S A
ㄲㅏㅈㅣㅇㅏㅅㅣㅇㅏㅈㅣㅇㅕㄱ	G A J I A S I A J I iEO G
ㄲㅏㅈㅣㅇㅣㅅㅣㅂㅇㅗ	G A J I I S I B O
ㄲㅏㄹ	G A L
ㄴㅏㄱㅏㄱㅗㅇㅣㅆㄷㅏㅁㅕㄴ	N A G A G O I t D A M iEO N
ㄴㅏㄱㅏㅈㅣㄴ	N A G A J I N
ㄴㅏㄴㅡㄴㅇㅗㄴㅡㄴㄱㅜㅇㅣㄹㅂㅜㅌㅓ	N A N EU N O N EU N G U I L B U Th EO
ㄴㅏㄹㅏㄴㅡㄴㅎㅏㄴㄱㅜㄱ	N A R A N EU N A N G U k
ㄴㅏㅇㅏㅈㅣㄱㅗㅇㅣㅆㄷㅏ	N A A J I G O I t D A
ㄴㅏㅇㅣㅎㅐㅇ	N A I AE NG
ㄴㅏㄴㅇㅡㄹㅈㅜ	N A N EU L J U
ㄴㅏㅁㅇㅏㅇㅣㄹㅈㅓㅇㅇㅡㄹ	N A M A I L J EO NG EU L
ㄴㅏㅊ	N A t
ㄴㅐㅆ	N AE S
ㄴㅕㄴㅇㅔㄴㅡㄴㅇㅣㄹㅂㅗㄴ	N iEO N E N EU N I L B O N
ㄴㅕㄴㅇㅣㅅㅏㅇㅇㅡㄹㅗ	N iEO N I S A NG EU R O
ㄴㅕㄴㅇㅣㄹㅊㅓㄴㅅㅏㅁ	N iEO N I L CHh EO N S A M
ㄴㅡㄴㄱㅓㅅㅇㅡㄹㅗㄴㅡㄴㅇㅗ	N EU N G EO S EU R O N EU N O
ㄴㅡㄴㄱㅓㅅㅇㅣㄹㅏㄱㅗㅅㅓㄹ	N EU N G EO S I R A G O S EO L
ㄴㅡㄴㄷㅏㄱㅗㅁㅏㄹㅎㅏㄱㅗㅇㅣㅂㅓㄴ	N EU N D A G O M A R H A G O I B EO N
ㄴㅡㄴㄷㅔㅇㅣㅂㅜㅌㅓㅅㅏㅁ	N EU N D E I B U Th EO S A M
ㄴㅡㄴㅅㅏㅈㅣㄴㅇㅡㄹ	N EU N S A J I N EU L
ㄴㅡㄴㅅㅣㅂㅇㅣㅇㅓㄱ	N EU N S I B I EO G
ㄴㅡㄴㅇㅗㄴㅡㄴㅅㅣㅂㅇㅣㅇㅣㄹㅂㅜㅌㅓㅅㅣㅂ	N EU N O N EU N S I B I I L B U Th EO S I p
ㄴㅡㄴㅇㅣㄷㅡㄹㅇㅡㄴ	N EU N I D EU R EU N
ㄴㅡㄴㅇㅣㅅㅣㅂㅇㅠㄱ	N EU N I S I B iU G
ㄴㅡㄴㅇㅣㄴㅅㅏㄱㅏ	N EU N I N S A G A
ㄴㅡㄴㅈㅓㅇㅂㅜㄱㅏㅇㅣㄹ	N EU N J EO NG B U G A I L
ㄴㅡㄴㅈㅣㄴㅏㄴㅎㅐㅈㅜ	N EU N J I N A N AE J U
ㄴㅡㄹㅇㅓㄴㅏㄴㅡㄴㄱㅓㅅㅇㅡㄹ	N EU R EO N A N EU N G EO S EU L
ㄴㅣㄷㅏㄴㅡㄴ	N I D A N EU N
ㄷㅏㄱㅏㅇㅏㅇㅣㅅㅣ	D A G A A I S I
ㄷㅏㄱㅗㄷㅏㅅㅣ	D A G O D A S I
ㄷㅏㄱㅗㅅㅓㄹ	D A G O S EO L
ㄷㅏㄱㅗㅈㅣㅈㅓㄱ	D A G O J I J EO Kh
ㄷㅏㄴㅡㄴㄱㅓㅅㅇㅣㅈㅓㅇ	Th A N EU N G EO S I J EO NG
ㄷㅏㄴㅡㄴㅈㅓㄴㅁㅏㅇㅇㅣㄴㅏㅇㅗ	D A N EU N J EO N M A NG I N A O
ㄷㅏㄹㅣㄴㅡㄴㄱㅓㅅㅇㅣㄷㅏ	D A R I N EU N G EO S I D A
ㄷㅏㅅㅏㅁㅅㅣㅂㅅㅏㅈㅓㅁㅇㅣㄹ	D A S A M S I p S A J EO M I L
ㄷㅏㅇㅣㅈㅜㅇ	D A I J U NG
ㄷㅏㄴㅇㅡㄹㅗㅇㅣㄴㅎㅏㄴ	D A N EU R O I N A N
ㄷㅏㄴㅇㅡㄴㅈㅣㄴㅏㄴㅇㅣㄹㅇㅝㄹ	D A N EU N J I N A N I R uEO L
ㄷㅏㄴㅇㅣㄴㅐ	D A N I N AE
ㄷㅏㄴㅇㅣㅈㅏ	D A N I J A
ㄷㅏㄴㅎㅏㄹㅏㄴㅡㄴ	D A N A R A N EU N
ㄷㅏㄹㄹㅓㄱㅏㄴㅡㄹㅇㅓ	D A L L EO G A N EU R EO
ㄷㅏㄹㅇㅣㅇㅣㄹㅂㅜㅌㅓㅅㅣㅎㅐㅇ	D A R I I L B U Th EO S I AE NG
ㄷㅏㅇㅅㅣㅇㅔㄷㅗㄱㅣ	D A NG S I E D O G I
ㄷㅏㅇㅇㅡㄴㅇㅣㄹㅇㅣㄹ	D A NG EU N I R I L
ㄷㅏㅇㅇㅣㅇㅗㄹ	D A NG I O R
ㄷㅏㅇㅎㅏㄴㅡㄴㄱㅓㅅ	D A NG H A N EU N G EO S
ㄷㅏㅇㅎㅏㄴㄱㅓㅅㅇㅡㄹㅗㅇㅗ	D A NG H A N G EO S EU R O O
ㄷㅐㄱㅏㄹㅗㄱㅣㅇㅓㅂㅊㅔ	D AE G A R O G I EO p CHh E
ㄷㅐㄱㅏㅇㅣㅇㅓㄱ	D AE G A I EO G
ㄷㅐㄱㅣㅅㅣㄱㅏㄴㅇㅣㅇㅣㅂㅐㄱ	D AE G I S I G A N I I B AE k
ㄷㅐㄹㅗㄴㅏㅅㅓㅆ	D AE R O N A S EO t
ㄷㅐㄹㅗㅅㅣㄹㅅㅣㅎㅏㄴㄷㅏㄱㅗㅂㅏㄺㅎㅕㅆㄷㅏ	D AE R O S I L S I A N D A G O B A Kh iEO t D A
ㄷㅐㄹㅗㅈㅏㄹㅣ	D AE R O J A R I
ㄷㅐㄹㅡㄹㅂㅏㄷㅇㅡㄴ	D AE R EU L B A D EU N
ㄷㅐㅅㅏㄱㅏㅅㅏㅁㅇㅣㄹ	D AE S A G A S A M I L
ㄷㅐㅅㅏㅇㅇㅡㄹㅗㅅㅏㅇㅓㅂ	D AE S A NG EU R O S A EO p
ㄷㅐㅅㅏㅇㅇㅡㄹㅗㅎㅏㄴㅡㄴㄱㅓㅅㅇㅡㄴㅇㅏㄴㅣ	D AE S A NG EU R O A N EU N G EO S EU N A N I
ㄷㅐㅇㅔㄱㅔ	D AE E G E
ㄷㅐㅇㅔㅈㅓㄱ	D AE E J EO Kh
ㄷㅐㅇㅣㄹㅡㅁ	D AE I R EU M
ㄷㅐㅈㅓㄱㅇㅡㄹㅗㄴㅡㄹㅇㅓㄴㅏ	D AE J EO G EU R O N EU R EO N A
ㄷㅐㅌㅗㅇㄹㅕㅇㅇㅡㄴㅇㅣㄴㅏㄹ	D AE Th O NG N iEO NG EU N I N A N
ㄷㅐㅌㅗㅇㄹㅕㅇㅇㅢㅅㅏㄴㅕㄴ	D AE Th O NG N iEO NG euI S A N iEO N
ㄷㅐㅎㅏㄱㅣㅇㅟㅎㅐㅈㅓㄴㄱㅜㄱ	D AE A G I UE AE J EO N G U G
ㄷㅐㅎㅏㄴㄱㅓㅅㅇㅡㄹㅗㄴㅏ	D AE A N G EO S EU R O N A
ㄷㅐㅎㅏㄹㄱㅓㅅㅇㅣㄹㅏㄱㅗㅁㅏㄹㅎㅐㅆㄷㅏ	D AE A L G EO S I R A G O M A R H AE t D A
ㄷㅓㄱ	D EO Kh
ㄷㅔㅇㅣㄴㅡㄴㄱㅜㅅㅣㅂㅊㅣㄹ	D E I N EU N G U S I p CHh I N
ㄷㅔㅇㅣㄹㅂㅜㄴㅡㄴㅅㅏ	D E I L B U N EU N S A
ㄷㅗㄱㅏㅇㅏㄴ	D O G A A N
ㄷㅗㄱㅣㄷㅐㅎㅏㄱㅣㅇㅓ	D O G I D AE A G I EO
ㄷㅗㄴㅡㄴㅇㅗㅇㅣ	D O N EU N O I
ㄷㅗㄹㅗㄱㅡㄹㅓㄴ	D O R O G EU R EO N
ㄷㅗㄹㅗㅅㅣㄹ	D O R O S I L
ㄷㅗㄹㅗㅈㅣㄴㅇㅣㅂㅎㅏㄴㄷㅏ	D O R O J I N I Ph A N D A
ㄷㅗㄹㅗㄱㅎㅏㄴㅡㄴㄱㅓㅅㅇㅣㄹㅏㄱㅗㅁㅏㄹㅎㅐㅆㄷㅏ	D O R O Kh A N EU N G EO S I R A G O M A R H AE t D A
ㄷㅗㅅㅏㅅㅣㄹㅇㅣㄷㅏ	D O S A S I R I D A
ㄷㅗㅅㅣㄴㅡㄴ	D O S I N EU N
ㄷㅗㅅㅣㅂㅇㅗㅂㅜㅌㅓㅅㅏㅁ	D O S I B O B U Th EO S A M
ㄷㅗㅇㅔㄷㅗㅇㅕㄴ	D O E D O iEO N
ㄷㅗㅇㅢㅎㅏㄴ	D O euI A N
ㄷㅗㅇㅣㅅㅣㅂ	D O I S I M
ㄷㅗㅇㅣㄹ	D O I N
ㄷㅗㅇㅣㅂㅎㅏㄴㅡㄴㅎㅏㄴㅍㅕㄴ	D O I Ph A N EU N A N Ph iEO N
ㄷㅗㅈㅏㄱㅣㅈㅓㄴ	D O J A G I J EO N
ㄷㅗㅈㅓㅇㅂㅜㅇㅢ	D O J EO NG B U euI
ㄷㅗㅎㅏㄱㅗㄴㅏㅅㅓ	D O A G O N A S EO
ㄷㅗㅎㅏㄴㅡㄴㅂㅏㅇ	D O A N EU N B A NG
ㄷㅗㅎㅏㄴㅇㅣㅂㅓㄴ	D O A N I B EO N
ㄷㅗㄱㅇㅡㄴㅇㅣㄱㅏㅌㅇㅡㄴㅇㅣㅇㅠ	D O G EU N I G A Th EU N I iU
ㄷㅗㄱㅇㅣㅇㅏㅈㅣㄱ	D O G I A J I k
ㄷㅗㄴㅇㅡㄹㅁㅏ	D O N EU L M A
ㄷㅗㅇㅇㅡㄹㄱㅏㅈ	D O NG EU L G A t
ㄷㅙㅆ	D O AE N
ㄷㅙㅆㄷㅏㄴㅡㄴㅅㅏㅅㅣㄹㅇㅡㄹ	D O AE t D A N EU N S A S I R EU L
ㄷㅚㄱㅗㅇㅣㄷㅡㄹㅇㅡㄴ	D OE G O I D EU R EU N
ㄷㅚㄱㅗㅇㅣㅆㄴㅡㄴㅇㅕ	D OE G O I N N EU N iEO
ㄷㅚㄱㅗㅇㅣㅆㄷㅏㅁㅕㄴㅅㅓ	D OE G O I t D A M iEO N S EO
ㄷㅚㄴㅡㄴㄱㅓㅅㅇㅡㄹ	D OE N EU N G EO S EU L
ㄷㅚㄴㅡㄴㅅㅣㅅㅓㄹ	D OE N EU N S I S EO L
ㄷㅚㄴㅡㄴㅇㅣㄹㅇㅣㅁㅏㄶㅇㅏㅆㄷㅏ	D OE N EU N I R I M A N A t D A
ㄷㅚㄴㄷㅏㄱㅗㅈㅜ	D OE N D A G O J U
ㄷㅜㄱㅗㄱㅣ	D U G O G I
ㄷㅜㄱㅗㅇㅣㅆㄷㅏㅁㅕ	D U G O I t D A M iEO
ㄷㅜㅇㅣㅅㅣㅂㅇㅗㅁㅏㄴㅅㅏㅁ	D U I S I B O M A N S A M
ㄷㅡㄹㅓㄴㅏ	D EU R EO N A
ㄷㅡㄹㅇㅓㄱㅏㄴㅐ	D EU R EO G A N AE
ㄷㅡㄹㅇㅓㅇㅣㅊㅓㄴ	D EU R EO I CHh EO N
ㄷㅡㄹㅇㅔㄷㅐㅎㅐㅅㅓㄴㅡㄴㅅㅣㅅㅓㄹ	D EU R E D AE AE S EO N EU N S I S EO L
ㄷㅡㄹㅇㅡㄴㅇㅗㄴㅡㄴㅇㅣㅅㅣㅂㄱㅜㅇㅣㄹㅂㅜㅌㅓㅅㅏㅁㅅㅣㅂㅇㅣㄹ	D EU R EU N O N EU N I S I p G U I L B U Th EO S A M S I B I L
ㄷㅡㄹㅇㅡㄴㅇㅣㄹㅂㅜ	D EU R EU N I L B U
ㄷㅡㄹㅇㅡㄹㅂㅗㄱㅗ	D EU R EU L B O G O
ㄷㅡㄹㅇㅢㅅㅏㅈㅣㄴㅇㅡㄹ	D EU R euI S A J I N EU R
ㄷㅡㄹㅇㅣㄱㅣㅇㅓㅂ	D EU R I G I EO Ph
ㄷㅡㄹㅇㅣㄹㅏㅁㅕㄴㅅㅓㅇㅣㄹㅂㅗㄴ	D EU R I R A M iEO N S EO I L B O N
ㄷㅡㄹㅇㅣㅅㅣㅈㅏㅇ	D EU R I S I J A NG
ㄷㅡㄹㅇㅣㅇㅣㄱㅏㅌㅇㅡㄴ	D EU R I I G A Th EU N
ㄷㅡㄹㅇㅣㅇㅣㅆㄷㅏㄱㅗㅈㅜ	D EU R I I t D A G O J U
ㄷㅡㄹㅇㅣㅎㅏㄴㄱㅜㄱㅇㅡㄴㅎㅐㅇ	D EU R I A N G U G EU N AE NG
ㄷㅡㅇㅇㅡㄹㅗㅅㅏㅅㅣㅂㅅㅏㅁ	D EU NG EU R O S A S I p S A M
ㄷㅡㅇㅇㅡㄹㅗㅈㅣㄴㅎㅐㅇ	D EU NG EU R O J I N AE NG
ㄷㅡㅇㅇㅡㄹㅇㅣㅅㅣㅂ	D EU NG EU R I S I M
ㄷㅡㅇㅇㅣㄴㅏ	D EU NG I N A
ㄷㅡㅇㅇㅣㅇㅣㅇㅔ	D EU NG I I E
ㄷㅣㅇㅗㄴㅡㄴㅇㅗㄴㅡㄴㅅㅏ	D I O N EU N O N EU N S A
ㄸㅏㄹㅏㅇㅣㅇㅘ	D A R A I oA
ㄸㅐㅁㅜㄴㅇㅔㅇㅣㄹㅡㅁ	D AE M U N E I R EU M
ㄸㅐㅁㅜㄴㅇㅣㄹㅏㄱㅗㅎㅏㄴㄷㅏ	D AE M U N I R A G O A N D A
ㄸㅗㄴㅡㄴㄱㅜㅇㅣㄹ	D O N EU N G U I L
ㄸㅗㅇㅣㄹㅗ	D O I R O
ㄸㅗㅎㅏㄴㅅㅏㅇ	D O A N S A NG
ㄹㅏㄱㅏㄱㅗㅇㅣㅆㄷㅏㄱㅗㅁㅏㄹㅎㅐㅆㄷㅏ	L A G A G O I t D A G O M A R H AE t D A
ㄹㅏㄱㅗㅅㅓㄴ	R A G O S EO N
ㄹㅏㄴㅏㄴㅡㄴ	L A N A N EU N
ㄹㅏㄴㅡㄴㅇㅣㅂ	R A N EU N I p
ㄹㅏㄷㅗㅇㅣㅎㅜ	L A D O I U
ㄹㅏㅇㅣㄴㅡㄴ	R A I N EU N
ㄹㅏㅈㅣㄱㅗ	L A J I G O
ㄹㅏㄱㅇㅡㄹㄱㅓ	N A G EU L G EO
ㄹㅏㄴㅎㅏㄴ	R A N A N
ㄹㅓㄱㅏㅅㅏㅅㅣㅂㅊㅣㄹㅈㅓㅁ	L EO G A S A S I p CHh I L J EO M
ㄹㅓㅅㅣㅇㅏㅇㅣㄹ	R EO S I A I L
ㄹㅔㅇㅣㅅㅣㅇㅏㄴㅐ	L E I S I A N AE
ㄹㅕㄴㅡㄴㅅㅏ	R iEO N EU N S A
ㄹㅕㄱㅇㅡㄹㄴㅏ	N iEO G EU N N A
ㄹㅕㄱㅇㅡㄹㅎㅏㄱㅗㅇㅣㅆㄷㅏㄱㅗㅁㅏㄹㅎㅐㅆㄷㅏ	R iEO G EU R H A G O I t D A G O M A R H AE t D A
ㄹㅕㄱㅇㅣㅇㅓㅄ	R iEO G I EO p S
ㄹㅕㄴㅇㅡㄹㄱㅏㅇ	N iEO N EU L G A NG
ㄹㅕㅁ	R iEO M
ㄹㅗ	L O
ㄹㅗㄱㅜㅅㅣㅂㅇㅗ	L O G U S I B O
ㄹㅗㄴㅏㅅㅓㅈㅣ	R O N A S EO J I
ㄹㅗㄴㅡㄴㅇㅣㅅㅣㅂㅇㅣㄹ	R O N EU N I S I B I L
ㄹㅗㄷㅏㅇㅣ	R O D A I
ㄹㅗㅂㅗㅎㅗ	L O B O O
ㄹㅗㅂㅜㅌㅓㅇㅣㄹㅂㅐㄱ	R O B U Th EO I L B AE G
ㄹㅗㅅㅏㅁㅅㅣㅂㅇㅣㅈㅓㅁ	L O S A M S I B I J EO M
ㄹㅗㅅㅣㅇㅣㄴㅎㅏㄴㄱㅓㅅㅇㅡㄹㅗㅈㅓㄴ	R O S I I N A N G EO S EU R O J EO N
ㄹㅗㅇㅏㅍ	L O A p
ㄹㅗㅇㅣㄷㅡㄹㅇㅔㄷㅐㅎㅏㄴ	R O I D EU R E D AE A N
ㄹㅗㅇㅣㅇㅓㅈㅣㄴ	L O I EO J I N
ㄹㅗㅇㅣㄹㅇㅓㄱ	N O I R EO G
ㄹㅗㅈㅏㄹㅗㅅㅓ	N O J A R O S EO
ㄹㅗㅈㅣㄴㅏㄴㅇㅣㄹ	R O J I N A N I L
ㄹㅗㅎㅏㄱㅣㄷㅗㅎㅐㅆㄷㅏ	R O A G I D O AE t D A
ㄹㅗㅎㅏㅂ	R O A B
ㄹㅗㄴㅇㅡㄹㅇㅓㄷ	L O N EU R EO D
ㄹㅠㄹ	L iU L
ㄹㅡㄹㄱㅏㄹㅣㄴㅡㄴㅂㅏㅇ	R EU L G A R I N EU N B A NG
ㄹㅡㄹㅂㅏㄷㅇㅡㄹ	R EU L B A D EU R
ㄹㅡㅅ	R EU S
ㄹㅣㄱㅏㅇㅗ	R I G A O
ㄹㅣㄱㅗ	N I G O
ㄹㅣㄱㅗㅇㅣㅆㄴㅡㄴㄱㅓㅅㅇㅡㄹㅗㅂㅜㄴ	R I G O I N N EU N G EO S EU R O B U N
ㄹㅣㄱㅣ	N I G I
ㄹㅣㄱㅣㅇㅔㅇㅣㄹㅡ	R I G I E I R EU
ㄹㅣㄴㅡㄴㄱㅜㅅㅣㅂㅇㅠㄱ	L I N EU N G U S I B iU k
ㄹㅣㄴㅡㄴㅇㅗㄴㅡㄴㅇㅗ	N I N EU N O N EU N O
ㄹㅣㄴㅡㄴㅇㅣㄹㅂㅜ	R I N EU N I L B U
ㄹㅣㄷㅡㄹㅇㅡㄴㅇㅣㄹㅂㅗㄴ	N I D EU R EU N I L B O N
ㄹㅣㄹㅗㅅㅣㅈㅏㄱ	R I R O S I J A Kh
ㄹㅣㅅㅏㄱㅏㅇㅣㅇㅏ	N I S A G A I A
ㄹㅣㅇㅏㅇㅣㅊㅓㄴ	L I A I CHh EO N
ㄹㅣㅇㅔㅈㅓㄴ	L I E J EO N
ㄹㅣㅇㅣㄴㅇㅣ	N I I N I
ㄹㅣㅈㅣㅇㅔㅅㅓㅇㅣ	L I J I E S EO I
ㄹㅣㅎㅏㄷㅏㄱㅗㅅㅓㄹ	R I A D A G O S EO L
ㄹㅣㅎㅏㄴㅇㅣㅂ	R I A N I p
ㄹㅣㅅ	R I Th
ㅁㅏㄹㅕㄴㅎㅏㅈㅣㅇㅏㄶㅇㅡㄹ	M A R iEO N A J I A N EU L
ㅁㅏㅁㅜㄹㅣㄹㅗㄷㅗㄹ	M A M U R I R O D O R
ㅁㅏㄴㅅㅏㅅㅣㅂㅇㅗㅁㅏㄴㅇㅗㅅㅣㅂㅇㅣ	M A N S A S I B O M A N O S I B I
ㅁㅏㄴㅇㅝㄴㅇㅔㅅㅓㅇㅣㅊㅓㄴㅅㅏㅁ	M A N uEO N E S EO I CHh EO N S A M
ㅁㅏㄴㅇㅝㄴㅇㅡㄹㅇㅣㄴ	M A N uEO N EU R I N
ㅁㅏㄴㅇㅡㄹㅗㅇㅣㅂ	M A N EU R O I Ph
ㅁㅏㄴㅇㅡㄹㅈㅣㅇㅝㄴ	M A N EU L J I uEO N
ㅁㅏㄴㅇㅣㅅㅣㅂㅅㅏㅅㅣㄱㅏㄴ	M A N I S I p S A S I G A N
ㅁㅏㄴㅇㅣㄹㅂㅐㄱㅇㅣㅅㅣㅂㅇㅓㄱㅇㅝㄴㅇㅣㅅㅏㅇ	M A N I L B AE G I S I B EO G uEO N I S A NG
ㅁㅏㄴㅎㅏㄴㅅㅏ	M A N A N S A
ㅁㅏㄶㅇㅡㄴㅈㅣㅈㅓㄱ	M A N EU N J I J EO k
ㅁㅏㄹㅇㅡㄹㅂㅗ	M A R EU L B O
ㅁㅏㅇㅇㅡㄹ	M A NG EU N
ㅁㅏㅈㅇㅏㄱㅏ	M A J A G A
ㅁㅐㅇㅣㅂㅎㅏㄱㅗㅇㅣㅊㅓㄴ	M AE I Ph A G O I CHh EO N
ㅁㅐㄱ	M AE NG
ㅁㅓㄴ	M EO N
ㅁㅕㄴㅅㅓㄱㅏㅈㅏㅇ	M iEO N S EO G A J A NG
ㅁㅕㄴㅅㅓㅈㅣㅇㅕㄱ	M iEO N S EO J I iEO k
ㅁㅕㄹ	M iEO R
ㅁㅕㅇㅇㅡㄹㄴㅏ	M iEO NG EU N N A
ㅁㅕㅇㅇㅣㄱㅡ	M iEO NG I G EU
ㅁㅕㅇㅇㅣㅅㅓㄴㄱㅓ	M iEO NG I S EO N G EO
ㅁㅕㅇㅇㅣㅈㅣㄴㅏㄴㅅㅣㅂㅇㅣㅇㅣㄹ	M iEO NG I J I N A N S I B I I N
ㅁㅗㄴㅡㄴㄱㅜㅅㅣㅂㅍㅏㄹ	M O N EU N G U S I p Ph A R
ㅁㅗㄹㅡㄹㅇㅣㄴㅏㄹㅏ	M O R EU R I N A R A
ㅁㅗㄱㅇㅡㄹㅗㄱㅣㅇㅓㅂㅊㅔ	M O G EU R O G I EO p CHh E
ㅁㅗㄱㅇㅡㄹㅇㅏㄹ	M O G EU R A L
ㅁㅜㄱㅏㄱㅏㄴㅡㅇ	M U G A G A N EU NG
ㅁㅜㄱㅣㄹㅡㄹ	M U G I R EU L
ㅁㅜㄴㅡㄴㅇㅣㅂ	M U N EU N I Ph
ㅁㅜㄴㅇㅔㅅㅓㄴㅡㄴㅇㅣ	M U N E S EO N EU N I
ㅁㅜㄴㅇㅡㄹㅗㅈㅏㄱㅡㅁ	M U N EU R O J A G EU M
ㅁㅜㄴㅇㅡㄹㅂㅗ	M U N EU L B O
ㅁㅜㄴㅇㅣㅁㅏㄶ	M U N I M A N
ㅁㅜㄴㅇㅣㅎㅏㄴ	M U N I A N
ㅁㅜㄴㅈㅔㄷㅗㄱㅏㄴㅡㅇ	M U N J E D O G A N EU NG
ㅁㅜㄹㅇㅡㄹㅌㅗㅇ	M U R EU L Th O NG
ㅁㅜㄹㅇㅣㅈㅣㅁㅏㄴ	M U R I J I M A N
ㅁㅣㄱㅜㄱㅇㅣㄴㅐ	M I G U G I N AE
ㅁㅣㄹㅡㄹ	M I R EU R
ㅁㅣㅎㅏㅈㅣㅁㅏㄴㅇㅣ	M I A J I M A N I
ㅁㅣㄴㄷㅡㄹㅇㅡㄹㅇㅣ	M I N D EU R EU R I
ㅁㅣㄴㄷㅡㄹㅇㅣㅈㅓㅇㅂㅜㅇㅢ	M I N D EU R I J EO NG B U euI
ㅁㅣㅊ	M I N
ㅂㅏㅇㅣㅆㄷㅏ	B A I t D A
ㅂㅏㄴㅇㅡㄹㅁㅏㅁㅜㄹㅣ	B A N EU L M A M U R I
ㅂㅏㄴㅇㅣㅇㅏㄴㅣ	B A N I A N I
ㅂㅏㄴㅎㅏㄱㅗㅇㅣㅆ	B A N A G O I t
ㅂㅏㄷㅇㅏㅇㅣㅅㅣㅂㅇㅗ	B A D A I S I B O
ㅂㅏㄹㅇㅡㄴㅇㅣㄴㅏㄹ	B A R EU N I N A L
ㅂㅏㅂ	B A M
ㅂㅐㄱㅇㅗㅅㅣㅂㅇㅣㅈㅓㅁ	B AE G O S I B I J EO M
ㅂㅐㄱㅇㅣㅇㅓㄱㅇㅝㄴ	B AE G I EO G uEO N
ㅂㅓㄹㅇㅣㄱㅣㄷㅗ	B EO R I G I D O
ㅂㅔㅇㅣㅅㅡ	B E I S EU
ㅂㅕㄴㅇㅣㄴㅇㅣㄱㅜㅇㅣㄹ	B iEO N I N I G U I L
ㅂㅗㄱㅏㅇㅣㅅㅣㅂㅇㅣㅇㅣㄹ	B O G A I S I B I I L
ㅂㅗㄱㅗㅅㅓㄴㅡㄴㅇㅣㅇㅓ	B O G O S EO N EU N I EO
ㅂㅗㄱㅗㅇㅣㅆㄷㅏㅁㅕ	B O G O I t D A M iEO
ㅂㅗㄱㅣㅅㅜㄹ	B O G I S U R
ㅂㅗㄴㅡㄴㅈㅓㄴㄱㅜㄱ	B O N EU N J EO N G U k
ㅂㅗㄷㅏㄴㅡㄴㅎㅕㄴ	B O D A N EU N iEO N
ㅂㅗㄷㅏㅇㅣㅂㅜㅌㅓㅅㅏㅈㅓㅁ	B O D A I B U Th EO S A J EO M
ㅂㅗㄷㅗㄴㅡㄴㅇㅏ	B O D O N EU N A
ㅂㅗㄹㅡㄹㅇㅣㅂㅐㄱㅇㅕ	B O R EU R I B AE G iEO
ㅂㅗㅇㅣㄱㅗㅅㅏ	B O I G O S A
ㅂㅗㅇㅣㅅㅏㄴㅡㄴ	B O I S A N EU N
ㅂㅗㅈㅏㅇㅔㄷㅐㅎㅏㄴ	B O J A E D AE A N
ㅂㅗㅎㅏㄱㅗㅇㅣㅆㄷㅏㄴㅡㄴ	B O A G O I t D A N EU N
ㅂㅗㅎㅏㄴㄱㅓㅅ	B O A N G EO S
ㅂㅗㅎㅗㄹㅡㄹㅇㅣㅇㅠ	B O O R EU R I iU
ㅂㅜㄱㅏㄱㅏㅈㅏㅇ	B U G A G A J A NG
ㅂㅜㄱㅏㅇㅣㄹㅂㅗㄴ	B U G A I L B O N
ㅂㅜㄴㅡㄴㅅㅏㅁㅇㅣㄹㅇㅗㅈㅓㄴ	B U N EU N S A M I R O J EO N
ㅂㅜㄴㅡㄴㅇㅣㄷㅡㄹㅇㅣㅅㅣㅂㅇㅣㄹ	B U N EU N I D EU R I S I B I L
ㅂㅜㄴㅡㄴㅈㅓㄴㅁㅏㅇ	B U N EU N J EO N M A NG
ㅂㅜㅂㅜㄴㅇㅣㄷㅐㅎㅕㅇ	B U B U N I D AE iEO NG
ㅂㅜㅅㅏㅇㅇㅡㄹㅇㅣㅇㅠ	B U S A NG EU R I iU
ㅂㅜㅇㅔㄸㅏㄹㅡㅁㅕㄴㅎㅏㄴㄱㅜㄱㅇㅣ	B U E D A R EU M iEO N A N G U G I
ㅂㅜㅇㅢㅇㅣㅎㅐㅇ	B U euI I AE NG
ㅂㅜㅈㅏㅇㅇㅔ	B U J A NG E
ㅂㅜㅈㅏㅇㅇㅣㅇㅏㅍ	B U J A NG I A Ph
ㅂㅜㅈㅣㅇㅗ	B U J I O
ㅂㅜㅌㅓㅅㅏㅅㅣㅂ	B U Th EO S A S I B
ㅂㅜㅌㅓㅅㅣㅂㅅㅏㅈㅓㅁ	B U Th EO S I p S A J EO M
ㅂㅜㅌㅓㅇㅣㅅㅣㅂㅅㅏㅁ	B U Th EO I S I p S A M
ㅂㅜㅌㅓㅇㅣㄹㅊㅓㄴㅇㅣㅂㅐㄱ	B U Th EO I L CHh EO N I B AE G
ㅂㅜㅎㅏㅈㅣㅇㅏㄶㅇㅏ	B U A J I A N A
ㅂㅜㄱㅎㅏㄴㅇㅣ	B U Kh A N I
ㅂㅜㄴㅇㅡㄹㄱㅏㅇ	B U N EU L G A NG
ㅂㅜㄴㅇㅣㅇㅓㅄ	B U N I EO p
ㅂㅣㄱㅏㅅㅏㅅㅏㅇ	B I G A S A S A NG
ㅂㅣㄴㅏㄴㅎㅏㄱㅗ	B I N A N A G O
ㅂㅣㄴㅡㄴㅇㅣㅁㅏㄴㅇㅗ	B I N EU N I M A N O
ㅂㅣㅅㅡㄴㅡㄴㅅㅣㅂ	B I S EU N EU N S I p
ㅂㅣㅇㅔㅇㅣㄱㅜ	B I E I G U
ㅂㅣㅈㅏㄷㅡㄹㅇㅔㄱㅔㅎㅏㄴ	B I J A D EU R E G E A N
ㅂㅣㅎㅏㄱㅣㅇㅟㅎㅏㄴㄱㅓㅅㅇㅡㄹㅗㅇㅏㄹ	B I A G I UE A N G EO S EU R O A L
ㅂㅣㅎㅐㅅㅏㅁㅅㅣㅂㅇㅣ	B I AE S A M S I B I
ㅂㅣㅎㅐㅇㅣㅅㅣㅂㅍㅏㄹ	B I AE I S I p Ph A L
ㅂㅣㅊ	B I t
ㅅㅏㄱㅏㅅㅏㄱㅓㄴ	S A G A S A G EO N
ㅅㅏㄱㅏㅇㅣㅆㄴㅡㄴㅅㅏㄹㅏㅁ	S A G A I N N EU N S A R A M
ㅅㅏㄱㅓㄴㅇㅡㄹㅇㅣㄹ	S A G EO N EU R I L
ㅅㅏㄱㅗㄴㅡㄴㅇㅣㅊㅓㄴ	S A G O N EU N I CHh EO N
ㅅㅏㄴㅕㄴ	S A N iEO N
ㅅㅏㄴㅡㄴㅇㅗㅅㅣㅂ	S A N EU N O S I p
ㅅㅏㄴㅡㄴㅈㅣㄴㅏㄴㄷㅏㄹ	S A N EU N J I N A N D A R
ㅅㅏㄷㅡㄹㅇㅡㄴㅎㅕㄴㅈㅐㅇㅣㄹㅂㅗㄴ	S A D EU R EU N iEO N J AE I L B O N
ㅅㅏㄷㅡㄹㅇㅣㅇㅣㅆ	S A D EU R I I S
ㅅㅏㄹㅗㄱㅣㅅㅜㄹ	S A R O G I S U R
ㅅㅏㄹㅡㄹㅁㅏㄹㅕㄴ	S A R EU L M A R iEO N
ㅅㅏㅁㅜㄱㅣㄱㅣ	S A M U G I G I
ㅅㅏㅅㅣㄹㅇㅡㄴㅎㅏㄴㄱㅜㄱ	S A S I R EU N A N G U k
ㅅㅏㅅㅣㅂㄱㅜㅈㅓㅁㅇㅣㄹㅇㅗㅅㅣㅂㄱㅜㅈㅓㅁ	S A S I p G U J EO M I R O S I p G U J EO M
ㅅㅏㅅㅣㅂㅇㅣㅇㅓㄱㅇㅝㄴㅇㅣ	S A S I B I EO G uEO N I
ㅅㅏㅇㅓㅂㅇㅡㄹㅇㅟㅎㅐㅈㅓㄴ	S A EO B EU R UE AE J EO N
ㅅㅏㅇㅔㄴㅡㄴㅅㅏㅁ	S A E N EU N S A M
ㅅㅏㅇㅔㅇㅣ	S A E I
ㅅㅏㅇㅣㄷㅗㅇ	S A I D O NG
ㅅㅏㅇㅣㅇㅣㅊㅓㄴㅅㅏㅁ	S A I I CHh EO N S A M
ㅅㅏㅇㅣㄹㅈㅓㅁ	S A I L J EO M
ㅅㅏㅈㅏㅇㅇㅡㄹㅗㄱㅗㅇ	S A J A NG EU R O G O NG
ㅅㅏㅈㅏㅇㅇㅣㅁㅕ	S A J A NG I M iEO
ㅅㅏㅈㅓㅇㅇㅣㅈㅣ	S A J EO NG I J I
ㅅㅏㅎㅏㅁㅕㄴ	S A A M iEO N
ㅅㅏㅎㅏㅇㅇㅡㄹㅁㅏㄹㅕㄴ	S A A NG EU L M A R iEO N
ㅅㅏㄴㅇㅡㄹㅗㄴㅏ	S A N EU R O N A
ㅅㅏㄴㅇㅡㄹㅂㅏㄷ	S A N EU L B A t
ㅅㅏㄴㅇㅣㅇㅗㅅㅣㅂㅇㅣ	S A N I O S I B I
ㅅㅏㄴㅎㅏㅁㅕㄴㅅㅓ	S A N A M iEO N S EO
ㅅㅏㅁㅅㅣㅂㅅㅏㄴㅕㄴ	S A M S I p S A N iEO N
ㅅㅏㅁㅅㅣㅂㅇㅣㅂㅜ	S A M S I B I B U
ㅅㅏㅁㅅㅣㅂㅇㅣㄹㅈㅓㅁㅇㅣㄹㅈㅓㅁ	S A M S I B I L J EO M I L J EO M
ㅅㅏㅇㅇㅡㄹㅗㄴㅏ	S A NG EU R O N A
ㅅㅏㅇㅇㅡㄴㅇㅣㄹㅇㅣㄹ	S A NG EU N I R I L
ㅅㅏㅇㅇㅡㄹㅂㅗㅇㅣㅁㅕ	S A NG EU L B O I M iEO
ㅅㅏㅇㅇㅣㄷㅏ	S A NG I D A
ㅅㅏㅇㅇㅣㅇㅣㄹㅂㅜㄱㅏ	S A NG I I L B U G A
ㅅㅏㅇㅎㅏㅁㅕ	S A NG H A M iEO
ㅅㅐㅇㅅㅏㄴㅅㅣㅅㅓㄹ	S AE NG S A N S I S EO R
ㅅㅐㅇㅅㅏㄴㅎㅏㄴㄱㅓㅅ	S AE NG S A N A N G EO t
ㅅㅓㄴㅡㄴㅅㅏㄱㅓㄴ	S EO N EU N S A G EO N
ㅅㅓㄴㅡㄴㅎㅏㄴㄱㅜㄱ	S EO N EU N A N G U k
ㅅㅓㅅㅣㅂㅇㅗ	S EO S I B O
ㅅㅓㅇㅣㅅㅣㅂㅍㅏㄹㅇㅣㄹ	S EO I S I p Ph A R I L
ㅅㅓㅎㅏㄴㄱㅜㄱㅇㅡㄴ	S EO A N G U G EU N
ㅅㅓㄴㅇㅡㄹㅁㅏ	S EO N EU L M A
ㅅㅓㄴㅇㅣㄹㅏㄷㅗ	S EO N I R A D O
ㅅㅓㄴㅎㅏㄴㅡㄴㅅㅏㄱㅗㄱㅏ	S EO N A N EU N S A G O G A
ㅅㅓㄹㅇㅣㄴㅏㅇㅗ	S EO R I N A O
ㅅㅓㅇㅇㅡㄹㅁㅏㅁㅜㄹㅣ	S EO NG EU L M A M U R I
ㅅㅓㅇㅇㅡㄹㅈㅜㅇㅣㄴ	S EO NG EU L J U I N
ㅅㅓㅇㅇㅣㅅㅏ	S EO NG I S A
ㅅㅓㅇㅇㅣㅇㅣㅆㄷㅏㄱㅗㅅㅓㄹ	S EO NG I I t D A G O S EO L
ㅅㅔㅇㅣㅅㅏㅇㅇㅡㄹ	S E I S A NG EU L
ㅅㅗㄱㅏㅇㅗㅈㅓㅁㅇㅣㄹ	S O G A O J EO M I L
ㅅㅗㄱㅣㅇㅓㅂㅇㅣㅈㅜㅇ	S O G I EO B I J U NG
ㅅㅗㄴㅡㄴㅈㅣㄴㅏㄴㄱㅜㅅㅣㅂㅇㅣㄹㄴㅕㄴ	S O N EU N J I N A N G U S I B I N N iEO N
ㅅㅗㅎㅏㄱㅗㄴㅏㅇㅏㄱㅏ	S O A G O N A A G A
ㅅㅗㅎㅏㅁㅕㄴ	S O A M iEO N
ㅅㅗㅎㅏㄴㅇㅣㄹㅈㅓㅁ	S O A N I L J EO M
ㅅㅗㄱㅇㅡㄹㅗㄱㅜㅅㅣㅂㅅㅏ	S O G EU R O G U S I p S A
ㅅㅚ	S OE
ㅅㅜㄱㅏㅅㅣㅈㅏㄱ	S U G A S I J A k
ㅅㅜㄱㅏㅇㅣㅆㄴㅡㄴ	S U G A I N N EU N
ㅅㅜㄴㅡㄴㅅㅣㅈㅏㅇ	S U N EU N S I J A NG
ㅅㅜㄴㅡㄴㅇㅣㅈㅓㅁㅇㅣ	S U N EU N I J EO M I
ㅅㅜㄷㅗㅇㅣㅆㄷㅏㄱㅗㅁㅏㄹ	S U D O I t D A G O M A R
ㅅㅜㄷㅡㄹㅇㅡㄹ	S U D EU R EU L
ㅅㅜㄷㅡㄹㅇㅣㅈㅓㄱ	S U D EU R I J EO G
ㅅㅜㅅㅏㄱㅣㄹㅗㄱㅇㅡㄹ	S U S A G I R O G EU N
ㅅㅜㅅㅏㅈㅏㅇㅇㅡㄴㅇㅣㄴㅏㄹ	S U S A J A NG EU N I N A R
ㅅㅜㅇㅣㅂㅐㄱㅇㅗㅅㅣㅂㅅㅏ	S U I B AE G O S I p S A
ㅅㅜㅇㅣㅂㅎㅏㄴ	S U I Ph A N
ㅅㅜㅇㅣㅆㄴㅡㄴㅈㅣㅂㅏㅇ	S U I N N EU N J I B A NG
ㅅㅜㅈㅜㄴㅇㅡㄹㅗㅂㅜㅅㅏㅇ	S U J U N EU R O B U S A NG
ㅅㅜㅈㅣㄴㅡㄴㅅㅏㅁㅅㅣㅂㅊㅣㄹ	S U J I N EU N S A M S I p CHh I R
ㅅㅜㅎㅏㄱㅗㅇㅣㅆㅇㅡㅁㅕ	S U A G O I S EU M iEO
ㅅㅜㅎㅏㄴ	S U A N
ㅅㅜㄹㅇㅡㄹㅂㅗ	S U R EU L B O
ㅅㅡㄴㅡㄴㅇㅗㅇㅣㄹ	S EU N EU N O I L
ㅅㅡㄹㅡㄹㅂㅏㄷ	S EU R EU L B A t
ㅅㅣㄱㅏㅇㅣㄹㅊㅓㄴ	S I G A I L CHh EO N
ㅅㅣㄱㅏㄴㅇㅡㄹㄱㅏㅈ	S I G A N EU L G A t
ㅅㅣㄱㅏㄴㅇㅣㅈㅣㄴㅏ	S I G A N I J I N A
ㅅㅣㄴㅡㄴㅂㅏㅇ	S I N EU N B A NG
ㅅㅣㄴㅡㄴㅈㅣㅎㅏ	S I N EU N J I A
ㅅㅣㅅㅏㅎㅏㄱㅗㄴㅏㅅㅓㅆ	S I S A A G O N A S EO S
ㅅㅣㅅㅓㄹㅇㅣㅎㅘㄱ	S I S EO R I oA k
ㅅㅣㅇㅔㅅㅓㄴㅡㄴㅇㅣㅅㅣㅂ	S I E S EO N EU N I S I p
ㅅㅣㅇㅣㄴㅇㅡㄹㅂㅏㄷㅇㅡㄴ	S I I N EU L B A D EU N
ㅅㅣㅈㅏㅇㅇㅔㅅㅓㄴㅡㄴㅇㅣㄷㅡㄹ	S I J A NG E S EO N EU N I D EU L
ㅅㅣㅈㅏㅇㅇㅡㄴㅈㅣ	S I J A NG EU N J I
ㅅㅣㅈㅏㅇㅇㅣㅇㅏㄴㅈㅓㅇ	S I J A NG I A N J EO NG
ㅅㅣㅈㅣㄴㅡㄴ	S I J I N EU N
ㅅㅣㅎㅏㄱㅣㄷㅗㅎㅐㅆㄷㅏ	S I A G I D O AE t D A
ㅅㅣㅎㅏㄴㄷㅏㅁㅕㄴㅅㅓㄱㅣ	S I A N D A M iEO N S EO G I
ㅅㅣㄱㅇㅡㄹㅗㄴㅏ	S I G EU R O N A
ㅅㅣㄱㅇㅡㄹㅂㅏㄹ	S I G EU L B A L
ㅅㅣㄱㅇㅣㅅㅣㄴ	S I G I S I N
ㅅㅣㄴㅇㅡㄹㄱㅏ	S I N EU L G A
ㅅㅣㄴㅇㅣㅅㅣㅂㅅㅏㅇㅣㄹ	S I N I S I p S A I L
ㅅㅣㄴㅎㅏㄱㅗㅈㅣ	S I N A G O J I
ㅅㅣㄹㅅㅣㅇㅣㅈㅓㄴㅇㅣㄱㅣ	S I L S I I J EO N I G I
ㅅㅣㄹㅅㅣㅎㅏㄹㅏㄱㅗㅈㅣㅂㅏㅇ	S I L S I A R A G O J I B A NG
ㅅㅣㄹㅇㅡㄴ	S I R EU N
ㅅㅣㄹㅇㅣㅂㅏㄹ	S I R I B A L
ㅅㅣㅁㅇㅡㄹㅈㅓㄴ	S I M EU L J EO N
ㅅㅣㅂㅅㅏㅁㅏㄴㄷㅏㄹㄹㅓ	S I p S A M A N D A L L EO
ㅅㅣㅂㅇㅗㅂㅜㅌㅓㅇㅣㅅㅣㅂㅇㅣ	S I B O B U Th EO I S I B I
ㅅㅣㅂㅇㅣㅂㅜㅌㅓㅇㅣㅅㅣㅂㅇㅗ	S I B I B U Th EO I S I B O
ㅅㅣㅂㅇㅣㄹ	S I B I R
ㅅㅣㅂㅊㅣㄹㅈㅓㅁㅇㅣㄹㅇㅣ	S I p CHh I L J EO M I R I
ㅆㅣㄱㅏㅅㅣㅂ	S I G A S I M
ㅆㅣㄱㅏㅈㅣㄴㅏㄴㅇㅣㄹㅇㅝㄹ	S I G A J I N A N I R uEO R
ㅆㅣㄴㅡㄴㅇㅗㅈㅓㅁㅇㅣㄹ	S I N EU N O J EO M I L
ㅆㅣㄴㅡㄴㅈㅣㄴㅏㄴㅇㅣㅇㅣㄹ	S I N EU N J I N A N I I L
ㅆㅣㅇㅔㄷㅐㅎㅏㄴㅇㅣㄹ	S I E D AE A N I L
ㅆㅣㅇㅣㄹ	S I I R
ㅇㅏㄴㅡㄴㄱㅜㅇㅣㄹ	A N EU N G U I L
ㅇㅏㅅㅣㅇㅏㄴㅏ	A S I A N A
ㅇㅏㅇㅣㅇㅏㅇㅣㅇㅏ	A I A I A
ㅇㅏㅈㅣㄱㅣㄷㅗ	A J I G I D O
ㅇㅏㄴㅇㅔㄸㅏㄹㅏㅇㅣㄷㅏㄹ	A N E D A R A I D A L
ㅇㅏㄴㅇㅡㄴㅇㅣㄹㅏ	A N EU N I R A
ㅇㅏㄴㅇㅡㄹㅇㅣㅂ	A N EU R I p
ㅇㅏㄴㅇㅣㅅㅣㅂㅇㅓㄱㅇㅝㄴ	A N I S I B EO G uEO N
ㅇㅏㄴㅈㅓㄴㅎㅏㄴㅅㅏㅇ	A N J EO N A N S A NG
ㅇㅏㄶㅇㅏㅆㄷㅏ	A N A t D A
ㅇㅐㅇㅣㄴㅇㅡㄹㅇㅟㅎㅏㄴㅅㅏ	AE I N EU R UE A N S A
ㅇㅐㄱㅇㅡㄴㅎㅕㄴㅈㅐ	AE G EU N iEO N J AE
ㅇㅐㄱㅇㅣㅈㅏㄱㅣㅈㅏ	AE G I J A G I J A
ㅇㅑㅎㅏㄴㄷㅏㄴㅡㄴㅂㅏㅇ	iA A N D A N EU N B A NG
ㅇㅓㄱㅏㄹㅡㄹ	EO G A R EU L
ㅇㅓㄴㅏㅈㅓㄴㄱㅜㄱ	EO N A J EO N G U k
ㅇㅓㄹㅣㄴㅇㅣㅅㅏㅁㅕㅇ	EO R I N I S A M iEO NG
ㅇㅓㅈㅣㄱㅗㅇㅣㅁㅕㅇ	EO J I G O I M iEO NG
ㅇㅓㅈㅣㄴㅡㄴㅅㅏㄹㅏㅇ	EO J I N EU N S A R A NG
ㅇㅓㄱㅇㅝㄴㅇㅡㄹㅗ	EO G uEO N EU R O
ㅇㅓㄱㅇㅝㄴㅇㅡㄹㅇㅣㅈㅓㅁ	EO G uEO N EU R I J EO M
ㅇㅓㅂㅇㅡㄹㅅㅣ	EO B EU L S I
ㅇㅓㅂㅇㅣㅅㅣㅁ	EO B I S I M
ㅇㅓㅂㅊㅔㄱㅏㅇㅣㄹㅂㅐㄱ	EO p CHh E G A I L B AE k
ㅇㅓㅂㅊㅔㄷㅡㄹㅇㅣㄱㅡ	EO p CHh E D EU R I G EU
ㅇㅓㅆㄷㅏㄱㅏㅈㅣㄴㅏㄴ	EO t D A G A J I N A N
ㅇㅓㅆㄷㅏㅁㅕㄴㅅㅓㅇㅣㄷㅡㄹ	EO t D A M iEO N S EO I D EU L
ㅇㅔㄴㅡㄴㅅㅏㅇㅜ	E N EU N S A U
ㅇㅔㄴㅡㄴㅇㅣㄷㅡㄹ	E N EU N I D EU R
ㅇㅔㄴㅡㄴㅈㅓㅇㅂㅜㄱㅏ	E N EU N J EO NG B U G A
ㅇㅔㄷㅐㅎㅏㄴㅇㅣㄹㅡㅁ	E D AE A N I R EU M
ㅇㅔㄷㅐㅎㅐㅅㅓㄴㅡㄴㅇㅗㄴㅡㄴㅅㅏㅁ	E D AE AE S EO N EU N O N EU N S A M
ㅇㅔㄷㅐㅎㅐㅇㅣㄹㅈㅓㅇ	E D AE AE I L J EO NG
ㅇㅔㄷㅗㅇㅣㄹㅡ	E D O I R EU
ㅇㅔㄸㅏㄹㅏㅇㅣㄱㅏㅌㅇㅡㄴ	E D A R A I G A Th EU N
ㅇㅔㄸㅏㄹㅡㄴㅡㄴㅅㅏㅁㅅㅣㅂ	E D A R EU N EU N S A M S I p
ㅇㅔㅅㅓㄴㅡㄴㄱㅜㅅㅣㅂㅅㅏㄴㅕㄴ	E S EO N EU N G U S I p S A N iEO N
ㅇㅔㅅㅓㄴㅡㄴㅇㅣㄹㅂㅐㄱ	E S EO N EU N I L B AE k
ㅇㅔㅅㅓㅇㅣㄷㅡㄹㅇㅡㄹ	E S EO I D EU R EU L
ㅇㅔㅅㅓㅇㅣㅈㅓㅁㅇㅣㄹ	E S EO I J EO M I L
ㅇㅔㅅㅓㅈㅣㄷㅗㅈㅏ	E S EO J I D O J A
ㅇㅔㅇㅣㄴㅏㄹ	E I N A R
ㅇㅔㅇㅣㅂㅐㄱㅇㅗㅅㅣㅂ	E I B AE G O S I B
ㅇㅔㅇㅣㅇㅓㅇㅣㅅㅣㅂㅊㅣㄹㅇㅣㄹ	E I EO I S I p CHh I R I R
ㅇㅔㅇㅣㄹㅇㅡㄹ	E I R EU L
ㅇㅔㅇㅣㅆㅇㅡㅁㅕ	E I S EU M iEO
ㅇㅕㄴㅎㅏㄴㅡㄴㅇㅣ	iEO N A N EU N I
ㅇㅕㅆㄷㅏㄱㅗㅂㅏㄺ	iEO t D A G O B A Kh
ㅇㅖㅈㅓㅇㅇㅣㅇㅓㅆㄷㅏㄱㅏ	iE J EO NG I EO t D A G A
ㅇㅗㄴㅡㄴㅅㅣㅂㅇㅣㅇㅣㄹ	O N EU N S I B I I L
ㅇㅗㄴㅡㄴㅇㅣㄴ	O N EU N I N
ㅇㅗㅅㅣㅂㅇㅗㅁㅏㄴㅇㅗ	O S I B O M A N O
ㅇㅗㅇㅣㄹㅇㅣㄴ	O I R I N
ㅇㅜㄱㅏㅈㅓㄴ	U G A J EO N
ㅇㅜㄹㅣㄱㅣㅇㅓㅂ	U R I G I EO B
ㅇㅜㄹㅣㄴㅡㄴㅇㅣㄹ	U R I N EU N I L
ㅇㅝㄱ	uEO G
ㅇㅝㄴㅇㅔㅅㅓㅇㅣㅅㅣㅂㅅㅏㅅㅣㄱㅏㄴ	uEO N E S EO I S I p S A S I G A N
ㅇㅝㄴㅇㅡㄹㅗㄱㅏㅇㅣㅂㅎㅏㅁㅕㄴㅇㅣㄹㅡㅁ	uEO N EU R O G A I Ph A M iEO N I R EU M
ㅇㅝㄴㅇㅡㄹㅗㅇㅣㅁㅏㄴ	uEO N EU R O I M A N
ㅇㅝㄴㅇㅡㄴㅅㅣㅂㅅㅏㅇㅣㄹㅂㅜㅌㅓ	uEO N EU N S I p S A I L B U Th EO
ㅇㅝㄴㅇㅡㄴㅇㅣㅇㅔㄸㅏㄹㅏㅇㅣㄴㅏㄹ	uEO N EU N I E D A R A I N A L
ㅇㅝㄴㅇㅡㄹㅂㅏㄷㅇㅏㄱㅏ	uEO N EU L B A D A G A
ㅇㅝㄴㅇㅣㄱㅜㅅㅣㅂㅇㅣㄹㄴㅕㄴ	uEO N I G U S I B I N N iEO N
ㅇㅝㄴㅇㅣㅅㅏㅁㅏㅇ	uEO N I S A M A NG
ㅇㅝㄴㅇㅣㅇㅣㅅㅣㅂㅊㅣㄹㅇㅣㄹㅂㅜㅌㅓ	uEO N I I S I p CHh I R I L B U Th EO
ㅇㅞ	U E
ㅇㅟㅎㅐㅇㅣㄷㅡㄹㅇㅣ	UE AE I D EU R I
ㅇㅠㄱㅅㅣㅂㅅㅏㅇㅣㄹ	iU k S I p S A I R
ㅇㅠㄱㅅㅣㅂㅊㅣㄹㅇㅣㄹ	iU k S I p CHh I R I L
ㅇㅡㄴㅏㅇㅣㅇㅔ	EU N A I E
ㅇㅡㄹㅗㄱㅏㄴㅡㄴㅇㅣㄹㅂㅜ	EU R O G A N EU N I L B U
ㅇㅡㄹㅗㄴㅏㄹㅏ	EU R O N A R A
ㅇㅡㄹㅗㄷㅏㄱㅏ	EU R O D A G A
ㅇㅡㄹㅗㅂㅜㅇㅕ	EU R O B U iEO
ㅇㅡㄹㅗㅅㅏㅁㅅㅣㅂㅇㅗㅂㅜㅌㅓㅅㅏㅁㅅㅣㅂㅇㅣㄹ	EU R O S A M S I B O B U Th EO S A M S I B I L
ㅇㅡㄹㅗㅇㅏㅇㅣㅅㅡ	EU R O A I S EU
ㅇㅡㄹㅗㅇㅣㅂㅜㅌㅓㅅㅏㅁㅇㅣㄹ	EU R O I B U Th EO S A M I L
ㅇㅡㄹㅗㅇㅣㄴㅎㅏㄴㅇㅣㄹㅂㅐㄱ	EU R O I N A N I L B AE k
ㅇㅡㄹㅗㅈㅣㄴㅏㄱㅏㄴㅡㄴ	EU R O J I N A G A N EU N
ㅇㅡㄹㅗㅎㅏㄴㅡㄴㅈㅓㅇ	EU R O A N EU N J EO NG
ㅇㅡㅁㅕㅇㅣㅇㅔ	EU M iEO I E
ㅇㅡㄴㅅㅏㅇㅓㅂ	EU N S A EO M
ㅇㅡㄴㅅㅣㅂㅇㅣㄹㅇㅣㄹㅂㅜㅌㅓ	EU N S I B I R I L B U Th EO
ㅇㅡㄴㅇㅗㅅㅣㅂ	EU N O S I p
ㅇㅡㄴㅇㅣㅁㅏㄴㅇㅗㅅㅣㅂㅇㅠㄱ	EU N I M A N O S I B iU k
ㅇㅡㄴㅇㅣㅅㅣㅂㅇㅗㅇㅣㄹㅇㅣㅅㅡㄹㅏ	EU N I S I B O I R I S EU R A
ㅇㅡㄴㅇㅣㅈㅓㅁㅇㅣ	EU N I J EO M I
ㅇㅡㄴㅇㅣㄹㅈㅓㅇㅇㅣㄷㅏ	EU N I L J EO NG I D A
ㅇㅡㄴㅈㅣㄴㅏㄴㅇㅣㅅㅣㅂㅇㅣㅇㅣㄹ	EU N J I N A N I S I B I I L
ㅇㅡㄴㅎㅏㅈㅣㅇㅏㄶㅇㅏㅆ	EU N A J I A N A S
ㅇㅡㄹㄱㅓㅅㅇㅡㄹㅗ	EU L G EO S EU R O
ㅇㅡㄹㄱㅓㅅㅇㅣㄹㅏㄱㅗㅅㅓㄴ	EU L G EO S I R A G O S EO N
ㅇㅡㄹㅁㅏㅁㅜㄹㅣㅎㅏㄱㅗ	EU L M A M U R I A G O
ㅇㅡㄹㅂㅗㄱㅗㅇㅣㅆㄴㅡㄴㄷㅔ	EU L B O G O I N N EU N D E
ㅇㅡㄹㅂㅗㅈㅏㅇㅎㅏ	EU L B O J A NG H A
ㅇㅡㄹㅇㅟㅎㅏㄴㄱㅓㅅㅇㅣㄹㅏㄱㅗㅅㅓㄹ	EU R UE A N G EO S I R A G O S EO L
ㅇㅡㄹㅇㅟㅎㅐㅈㅣㄴㅏㄴㄱㅜㅅㅣㅂ	EU R UE AE J I N A N G U S I M
ㅇㅡㄹㅇㅣㄹㅂㅐㄱ	EU R I L B AE NG
ㅇㅡㄹㅈㅣㄴㅏㄴㄱㅜㅅㅣㅂㅅㅏㅁ	EU L J I N A N G U S I p S A M
ㅇㅡㄹㅌㅗㅇㅎㅐㅇㅣㄷㅡㄹㅇㅢ	EU L Th O NG H AE I D EU R euI
ㅇㅡㄹㅎㅏㄱㅣㅇㅔㄴㅡㄴ	EU R H A G I E N EU N
ㅇㅡㅁㅇㅡㄹㅗㅂㅏㄺㅎㅕㅆㄷㅏ	EU M EU R O B A Kh iEO t D A
ㅇㅡㅁㅇㅡㄹㅗㅈㅣㄴㅏㄴㄷㅏㄹ	EU M EU R O J I N A N D A L
ㅇㅢㄱㅕㅇㅇㅜㅇㅣㄷㅡㄹ	euI G iEO NG U I D EU L
ㅇㅢㅅㅏㅅㅣㅂㅇㅣ	euI S A S I B I
ㅇㅢㅇㅏㅇㅣㄷㅡㄹㅇㅔ	euI A I D EU R E
ㅇㅢㅇㅣㅅㅣㅂㅅㅏㅈㅓㅁㅇㅣ	euI I S I p S A J EO M I
ㅇㅢㅎㅏㄴㄷㅏ	euI A N D A
ㅇㅣㄱㅏㅌㅇㅡㄴㅅㅏㅅㅣㄹㅇㅡㄴㅎㅏㄴ	I G A Th EU N S A S I R EU N A N
ㅇㅣㄱㅗㅇㅣㅂ	I G O I p
ㅇㅣㄱㅜㅇㅣㅂ	I G U I p
ㅇㅣㄴㅏㄱㅏㄱㅕㄱ	I N A G A G iEO G
ㅇㅣㄴㅏㄹㅇㅗㅈㅓㄴㅇㅔ	I N A R O J EO N E
ㅇㅣㄴㅡㄴㅇㅣㄴ	I N EU N I N
ㅇㅣㄷㅏㄹㅏㄱㅗㅁㅏㄹㅎㅐㅆ	I D A R A G O M A R H AE t
ㅇㅣㄷㅡㄹㅇㅡㄴㅇㅗㅎㅜㅅㅏㅁ	I D EU R EU N O U S A M
ㅇㅣㄷㅡㄹㅇㅣㅇㅏㅈㅣㄱ	I D EU R I A J I k
ㅇㅣㄹㅏㄱㅗㅈㅓㅇㅂㅜㅇㅢㅎㅏㄴ	I R A G O J EO NG B U euI A N
ㅇㅣㄹㅏㄷㅗㅅㅏ	I R A D O S A
ㅇㅣㅁㅏㄴㅇㅗ	I M A N O
ㅇㅣㅁㅕㅇㅇㅣㄱㅜ	I M iEO NG I G U
ㅇㅣㅂㅐㄱㅇㅣㅅㅣㅂㅇㅣ	I B AE G I S I B I
ㅇㅣㅅㅏㄹㅗㅂㅜㅌㅓ	I S A R O B U Th EO
ㅇㅣㅅㅏㅈㅏㅇㅇㅡㄹ	I S A J A NG EU L
ㅇㅣㅅㅏㅇㅇㅡㄹ	I S A NG EU R
ㅇㅣㅅㅣㄱㅏ	I S I G A
ㅇㅣㅅㅣㅂㅅㅏㅇㅣㄹㅂㅜㅌㅓㅇㅣㅅㅣㅂㅇㅣㄹ	I S I p S A I L B U Th EO I S I B I L
ㅇㅣㅅㅣㅂㅇㅣㅂㅜㅌㅓ	I S I B I B U Th EO
ㅇㅣㅅㅣㅂㅊㅣㄹㅇㅣㄹㅇㅗㅎㅜ	I S I p CHh I R I R O U
ㅇㅣㅇㅓㅇㅣㄴㅏㄹㅇㅗㅎㅜ	I EO I N A R O U
ㅇㅣㅇㅔㄸㅏ	I E D A
ㅇㅣㅇㅗㄴㅡㄴㅅㅣㅂ	I O N EU N S I B
ㅇㅣㅇㅣㄹㅡㄹ	I I R EU L
ㅇㅣㅇㅣㅇㅓㅈㅣㄱㅗㅈㅣㅎㅏ	I I EO J I G O J I A
ㅇㅣㅇㅣㄹㅇㅗㅈㅓㄴ	I I R O J EO N
ㅇㅣㅇㅣㅆㄷㅏㄱㅗㅂㅏㄺ	I I t D A G O B A Kh
ㅇㅣㅈㅓㄴㅇㅔㄴㅡㄴㅇㅕㄴ	I J EO N E N EU N iEO N
ㅇㅣㅈㅣㄴㅏㄴㅇㅣㅅㅣㅂㅇㅣㅇㅣㄹ	I J I N A N I S I B I I R
ㅇㅣㅊㅓㄴㅇㅣㅂㅐㄱㅇㅗㅅㅣㅂㅅㅏ	I CHh EO N I B AE G O S I p S A
ㅇㅣㅎㅏㅈㅣㄴㅡㄴ	I A J I N EU N
ㅇㅣㄱㅇㅡㄹㄱㅓ	I G EU L G EO
ㅇㅣㄴㅅㅏㄷㅡㅇ	I N S A D EU NG
ㅇㅣㄴㅇㅏㅇㅣㄷㅡㄹ	I N A I D EU L
ㅇㅣㄴㅇㅡㄹㄱㅏㅈㅏㅇ	I N EU L G A J A NG
ㅇㅣㄴㅇㅣㄴㅐ	I N I N AE
ㅇㅣㄴㅇㅣㅅㅣㄹ	I N I S I L
ㅇㅣㄴㅇㅣㅇㅗ	I N I O
ㅇㅣㄴㅇㅣㄹㅊㅓㄴㅅㅏㅁ	I N I L CHh EO N S A M
ㅇㅣㄴㅎㅏㅈㅣㅇㅏㄶㅇㅡㄹ	I N A J I A N EU L
ㅇㅣㄹㄴㅕㄴㅇㅔㄴㅡㄴ	I N N iEO N E N EU N
ㅇㅣㄹㅂㅜㄱㅏㅎㅏㄴ	I L B U G A A N
ㅇㅣㄹㅇㅗㅈㅓㄴ	I R O J EO N
ㅇㅣㄹㅇㅡㄹㅎㅏ	I R EU R H A
ㅇㅣㄹㅇㅣㅇㅓㅄ	I R I EO p S
ㅇㅣㄹㅇㅣㄹㅇㅣ	I R I R I
ㅇㅣㅀ	I L
ㅇㅣㅁㅇㅣㅇㅣㅅ	I M I I t
ㅇㅣㅆㄴㅡㄴㄱㅓㅅㅇㅡㄹㅗㅇㅏㄹ	I N N EU N G EO S EU R O A L
ㅇㅣㅆㄷㅏㄱㅏㅇㅣㄹ	I t D A G A I L
ㅇㅣㅈ	I J
ㅈㅏㄱㅏㅅㅏㅁㅅㅣㅂㅇㅣㅈㅓㅁ	J A G A S A M S I B I J EO M
ㅈㅏㄱㅏㅇㅣㅆㄴㅡㄴㄷㅔ	J A G A I N N EU N D E
ㅈㅏㄱㅡㅁㅇㅡㄹㅇㅣㄹ	J A G EU M EU R I L
ㅈㅏㄴㅡㄴㄷㅡㅇ	J A N EU N D EU NG
ㅈㅏㄴㅡㄴㅇㅣㄹㅡㄹ	J A N EU N I R EU R
ㅈㅏㄴㅡㄴㅈㅣㄴㅏㄴㅎㅐㅅㅏㅁ	J A N EU N J I N A N AE S A M
ㅈㅏㄷㅡㄹㅇㅔㄷㅐㅎㅐ	J A D EU R E D AE AE
ㅈㅏㄷㅡㄹㅇㅡㄹㅇㅟㅎㅐ	J A D EU R EU R UE AE
ㅈㅏㄷㅡㄹㅇㅣㅅㅣㅈㅏㅇ	J A D EU R I S I J A NG
ㅈㅏㄷㅡㅇㅇㅡㄹ	J A D EU NG EU N
ㅈㅏㄹㅗㅇㅕㅇ	J A R O iEO NG
ㅈㅏㄹㅡㄹㅇㅣㄹ	J A R EU R I L
ㅈㅏㅅㅏㄴㅡㄴㅇㅣㅊㅓㄴ	J A S A N EU N I CHh EO N
ㅈㅏㅅㅣㄴㅇㅣㅇㅣㅂ	J A S I N I I p
ㅈㅏㅇㅔㄸㅏㄹㅏㅇㅣ	J A E D A R A I
ㅈㅏㅇㅢㅎㅏㄴㄱㅜㄱ	J A euI A N G U G
ㅈㅏㅇㅣㄴ	J A I N
ㅈㅏㅎㅏㄴㄱㅜㄱ	J A A N G U NG
ㅈㅏㄱㅇㅓㅂㅇㅣㅇㅣ	J A G EO B I I
ㅈㅏㅇㄱㅘㄴㅇㅡㄴㅈㅣㄴㅏㄴㄱㅜㅅㅣㅂㅇㅣㄹㄴㅕㄴ	J A NG G oA N EU N J I N A N G U S I B I N N iEO N
ㅈㅏㅇㅇㅔㅅㅓㄴㅡㄴㄴㅗㄷㅗㅇ	J A NG E S EO N EU N N O D O NG
ㅈㅏㅇㅇㅡㄹㅗㅂㅏ	J A NG EU R O B A
ㅈㅏㅇㅇㅡㄴ	J A NG EU N
ㅈㅏㅇㅇㅡㄴㅇㅣㄷㅡㄹ	J A NG EU N I D EU R
ㅈㅏㅇㅇㅡㄴㅈㅣ	J A NG EU N J I
ㅈㅏㅇㅇㅡㄹㅁㅏㄹㅕㄴㅎㅏㄴㅡㄴ	J A NG EU L M A R iEO N A N EU N
ㅈㅏㅇㅇㅡㄹㅇㅣㅅㅣㅂㅇㅣㄹ	J A NG EU R I S I B I L
ㅈㅏㅇㅇㅣㄱㅜㅅㅣㅂㅇㅣㄴㅕㄴ	J A NG I G U S I B I N iEO N
ㅈㅏㅇㅇㅣㅅㅏ	J A NG I S A
ㅈㅏㅇㅇㅣㅇㅣㄷㅡㄹㅇㅡㄹ	J A NG I I D EU R EU L
ㅈㅏㅇㅇㅣㅎㅏㄴ	J A NG I A N
ㅈㅏㅇㅎㅏㄴㅡㄴㄷㅡㅇ	J A NG H A N EU N D EU NG
ㅈㅐㄱㅏㄹㅡㄹ	J AE G A R EU R
ㅈㅐㅅㅏㄴㅇㅣㅇㅣㄹㅇㅓㄱㅇㅝㄴ	J AE S A N I I R EO G uEO N
ㅈㅐㄹ	J AE L
ㅈㅓㄱㅇㅡㄹㅗㄴㅡㄹㅇㅓㄴㅏㄱㅗㅇㅣㅇㅔㄸㅏㄹㅏㅇㅣㄹ	J EO G EU R O N EU R EO N A G O I E D A R A I L
ㅈㅓㄱㅇㅡㄹㅗㅅㅣㅇㅣㄴㅎㅏㄱㅗㅇㅣㅆㄷㅏ	J EO G EU R O S I I N A G O I t D A
ㅈㅓㄱㅇㅡㄹㅗㅇㅣㅇㅠ	J EO G EU R O I iU
ㅈㅓㄱㅇㅡㄹㅗㅎㅏ	J EO G EU R O A
ㅈㅓㄱㅇㅡㄹㅇㅣㄴ	J EO G EU R I N
ㅈㅓㄱㅇㅣㄹㅏㄴㅡㄴㅇㅗ	J EO G I R A N EU N O
ㅈㅓㄱㅇㅣㅇㅣㅆㄷㅏ	J EO G I I t D A
ㅈㅓㄴㄱㅜㄱ	J EO N G U k
ㅈㅓㄴㅇㅔㄷㅐㅎㅐㅈㅓㄴ	J EO N E D AE AE J EO N
ㅈㅓㄴㅇㅔㅈㅓㄴㄱㅜㄱ	J EO N E J EO N G U k
ㅈㅓㄴㅇㅡㄹㅎㅏㄱㅗㅇㅣㅆㄴㅡㄴ	J EO N EU R H A G O I N N EU N
ㅈㅓㄴㅇㅣㅈㅜ	J EO N I J U
ㅈㅓㄴㅎㅏㄴㅅㅏㅅㅏㅇㅇㅣ	J EO N A N S A S A NG I
ㅈㅓㅁㅇㅡㄹㅇㅣㄹ	J EO M EU R I L
ㅈㅓㅅ	J EO N
ㅈㅓㅇㅂㅜㄴㅡㄴㄴㅗㅈㅓㄴ	J EO NG B U N EU N N O J EO N
ㅈㅓㅇㅂㅜㄴㅡㄴㅇㅣㄹㅂㅗㄴ	J EO NG B U N EU N I L B O N
ㅈㅓㅇㅂㅜㅈㅣㅇㅝㄴㅇㅣㄱㅜ	J EO NG B U J I uEO N I G U
ㅈㅓㅇㅇㅡㄹㅈㅣㅅㅣ	J EO NG EU L J I S I
ㅈㅓㅇㅇㅣㅂㅜㄹ	J EO NG I B U L
ㅈㅓㅇㅇㅣㅎㅕㄴ	J EO NG I iEO N
ㅈㅓㅇㅎㅏㄱㅗㅈㅣㄴㅏㄴ	J EO NG H A G O J I N A N
ㅈㅓㅇㅎㅏㅈㅏ	J EO NG H A J A
ㅈㅔㄱㅏㅇㅗ	J E G A O
ㅈㅔㄷㅗㄹㅡㄹ	J E D O R EU R
ㅈㅔㅅㅣㅎㅏㄱㅗㄱㅣㅁ	J E S I A G O G I M
ㅈㅔㅅㅣㅎㅐㅆㄷㅏ	J E S I AE t D A
ㅈㅔㅇㅣㄹㅇㅣㄴ	J E I R I N
ㅈㅔㅎㅏㄱㅗㅇㅣㅆㄴㅡㄴㄷㅔ	J E A G O I N N EU N D E
ㅈㅔㅎㅏㄴㄱㅓㅅ	J E A N G EO t
ㅈㅔㅎㅏㄴㅎㅏㅈㅏㄴㅡㄴㄱㅓㅅㅇㅣㄷㅏ	J E A N A J A N EU N G EO S I D A
ㅈㅕㅆㄷㅏㅇㅣ	J iEO t D A I
ㅈㅗㅅㅏㄱㅏㄱㅏㄴㅡㅇ	J O S A G A G A N EU NG
ㅈㅗㅅㅏㄹㅡㄹㅂㅏㄷㅇㅏㅆ	J O S A R EU L B A D A t
ㅈㅗㅅㅏㅇㅣㄹㅡㄹ	J O S A I R EU L
ㅈㅗㅅㅏㅎㅏㄴㄱㅓㅅㅇㅣㅇㅓ	J O S A A N G EO S I EO
ㅈㅗㅈㅓㅇ	J O J EO NG
ㅈㅗㅈㅣㄱㅇㅡㄹㅈㅓㄴㄱㅜㄱ	J O J I G EU L J EO N G U k
ㅈㅗㅎㅏㅁㅕㅇㅣㅂㅓㄴ	J O A M iEO I B EO N
ㅈㅗㄹ	J O N
ㅈㅜㄱㅏㄱㅏㅇㅗㄹ	J U G A G A O L
ㅈㅜㄱㅏㅇㅣㅂㅐㄱ	J U G A I B AE k
ㅈㅜㄱㅣㅈㅣㅇㅢ	J U G I J I euI
ㅈㅜㄴㅡㄴㅇㅣㄹㅂㅐㄱ	J U N EU N I L B AE G
ㅈㅜㄹㅡㄹㅇㅣㄹ	J U R EU R I L
ㅈㅜㅇㅢ	J U euI
ㅈㅜㅈㅏㅇㅇㅡㄴ	J U J A NG EU N
ㅈㅜㅈㅏㅇㅎㅏㅁㅕ	J U J A NG H A M iEO
ㅈㅜㅎㅏㄴㅡㄴ	J U A N EU N
ㅈㅜㄴㅇㅣㄹㅏㄱㅗㅈㅓㄴ	J U N I R A G O J EO N
ㅈㅜㄹㅇㅣㅈㅏㄴㅡㄴ	J U R I J A N EU N
ㅈㅣㄱㅏㄷㅏ	J I G A D A
ㅈㅣㄱㅏㅇㅣㅆㄷㅏㄱㅗㄱㅏㅇ	J I G A I t D A G O G A NG
ㅈㅣㄱㅗㅇㅣㅆ	J I G O I t
ㅈㅣㄱㅜㅇㅔㄷㅐㅎㅐㅅㅓㄴㅡㄴㅅㅏㅁ	J I G U E D AE AE S EO N EU N S A M
ㅈㅣㄴㅏㄷㅏ	J I N A D A
ㅈㅣㄴㅏㄴㄷㅏㄹㅇㅣㅅㅣㅂㅇㅗㅇㅣㄹㅂㅜㅌㅓ	J I N A N D A R I S I B O I L B U Th EO
ㅈㅣㄴㅏㄴㅇㅣㅅㅣㅂㅇㅗㅂㅜㅌㅓㅇㅣㅅㅣㅂㅇㅠㄱ	J I N A N I S I B O B U Th EO I S I B iU G
ㅈㅣㄴㅏㄴㅎㅐㅇㅣㄷㅡㄹ	J I N A N AE I D EU L
ㅈㅣㄴㅡㄴㅅㅏ	J I N EU N S A
ㅈㅣㄴㅡㄴㅇㅣ	J I N EU N I
ㅈㅣㄷㅗㄹㅗㄱㅎㅏㄴㅡㄴㄷㅔ	J I D O R O Kh A N EU N D E
ㅈㅣㄷㅗㅈㅏㄷㅡㄹㅇㅡㄴㅇㅣㅅㅣㅂㅅㅏㅁㅇㅣㄹ	J I D O J A D EU R EU N I S I p S A M I R
ㅈㅣㄷㅡㅇㅇㅣㅁㅏㄶㅇㅏ	J I D EU NG I M A N A
ㅈㅣㄹㅡㄹㄱㅏㄹㅣㄱㅗㅇㅣㅆㄴㅡㄴㄱㅓㅅㅇㅡㄹㅗㅇㅏㄹ	J I R EU L G A R I G O I N N EU N G EO S EU R O A L
ㅈㅣㅁㅏㄴㅇㅣㅂㅜㅌㅓㅅㅏㅁ	J I M A N I B U Th EO S A M
ㅈㅣㅂㅜㄴㅡㄴㅅㅣㅂㅇㅣㄹㅇㅣㄹ	J I B U N EU N S I B I R I L
ㅈㅣㅂㅜㄴㅇㅡㄹ	J I B U N EU L
ㅈㅣㅅㅏㅇㅔㅇㅣㄴ	J I S A E I N
ㅈㅣㅅㅣㅎㅐㅆ	J I S I AE t
ㅈㅣㅇㅏㄶㅇㅏㅆㄷㅏㅁㅕㄴㅅㅓ	J I A N A t D A M iEO N S EO
ㅈㅣㅇㅏㄶㅇㅡㄹㄱㅓㅅㅇㅣㄹㅏㅁㅕㄴㅅㅓ	J I A N EU L G EO S I R A M iEO N S EO
ㅈㅣㅇㅔㅇㅣㅅㅏㅇ	J I E I S A NG
ㅈㅣㅇㅝㄴㅇㅡㄹㅂㅏㄷ	J I uEO N EU L B A D
ㅈㅣㅇㅢㅅㅏㅅㅣㅂ	J I euI S A S I B
ㅈㅣㅇㅣㄹㅈㅓㅇ	J I I L J EO NG
ㅈㅣㅈㅓㅇㅎㅏㄴㅡㄴㄷㅡㅇ	J I J EO NG H A N EU N D EU NG
ㅈㅣㅈㅣㅇㅕㄱ	J I J I iEO k
ㅈㅣㅎㅏㄱㅗㅇㅣㅆㄴㅡㄴㅇㅣㄴ	J I A G O I N N EU N I N
ㅈㅣㅎㅏㄷㅗㄹㅗㄱ	J I A D O R O G
ㅈㅣㅎㅏㄹㅅㅜㅇㅣㅆㄷㅏㄴㅡㄴ	J I A L S U I t D A N EU N
ㅈㅣㄱㅇㅣㅁㅇㅣㄴㅡㄹ	J I G I M I N EU L
ㅈㅣㄴㅇㅡㄹㅈㅜ	J I N EU L J U
ㅈㅣㄴㅇㅣㅂㅎㅏㄴㅡㄴ	J I N I Ph A N EU N
ㅈㅣㄴㅎㅏㄴㅇㅣㅇㅠ	J I N A N I iU
ㅉㅏㄹㅣㄱㅏㄱㅏㄱ	J A R I G A G A k
ㅉㅗㄱㅇㅡㄹㅗㅈㅓㄴ	J O G EU R O J EO N
ㅊㅏㄱㅏㅎㅏ	CHh A G A A
ㅊㅏㄹㅡㄹㄱㅏㅎㅏㄱㅗㅇㅣㅆㄴㅡㄴㄱㅓㅅ	CHh A R EU L G A A G O I N N EU N G EO t
ㅊㅏㅈㅏㅇㅇㅔㄴㅡㄴㅇㅣㄹㅈㅓㅇ	CHh A J A NG E N EU N I L J EO NG
ㅊㅏㅈㅣㅇㅏㄶㅇㅡㄴ	CHh A J I A N EU N
ㅊㅏㅈㅣㅎㅏㄴㅇㅣㄴㅏㄹ	CHh A J I A N I N A L
ㅊㅏㄹㅇㅡㄴㅇㅣㄷㅏㄹ	CHh A R EU N I D A L
ㅊㅏㄹㅇㅣㅅㅣㄹㅅㅣ	CHh A R I S I L S I
ㅊㅐㄱㅇㅡㄹㅁㅏㄹㅕㄴㅎㅏㄱㅗㅇㅣㅆㄷㅏㄱㅗ	CHh AE G EU L M A R iEO N A G O I t D A G O
ㅊㅐㄱㅇㅣㅇㅓㅆㄷㅏ	CHh AE G I EO t D A
ㅊㅓㄹㅣㄹㅗㅂㅏ	CHh EO R I R O B A
ㅊㅓㄹㅣㅎㅏㄴㄱㅓㅅㅇㅡㄴ	CHh EO R I A N G EO S EU N
ㅊㅓㄴㅇㅣㅂㅐㄱㅇㅣ	CHh EO N I B AE G I
ㅊㅔ	CHh E
ㅊㅔㄱㅏㅈㅣㄴㅏㄴㅎㅐㅅㅣㅂㅇㅣㄹ	CHh E G A J I N A N AE S I B I R
ㅊㅔㄷㅡㄹㅇㅣㅇㅣ	CHh E D EU R I I
ㅊㅔㅈㅓㄱㅇㅡㄹㅗㅇㅣㅇㅔ	CHh E J EO G EU R O I E
ㅊㅜㄱㅏㄹㅗㅅㅣㅂㅇㅣㄹ	CHh U G A R O S I B I L
ㅊㅜㄱㅏㅎㅏㄴㄱㅓㅅㅇㅡㄴㅇㅣㄹ	CHh U G A A N G EO S EU N I L
ㅊㅜㅈㅣㄴㅎㅏㄱㅗㅇㅣㅆㅇㅡㅁㅕㅇㅣㅁㅣ	CHh U J I N A G O I S EU M iEO I M I
ㅊㅜㅈㅣㄴㅎㅏㄹㅅㅜㅇㅣㅆ	CHh U J I N A L S U I t
ㅊㅜㄹㅇㅣㄹㅏ	CHh U R I R A
ㅊㅣ	CHh I
ㅊㅣㄱㅗㄴㅏ	CHh I G O N A
ㅊㅣㄱㅗㅈㅓㅇㅂㅜ	CHh I G O J EO NG B U
ㅊㅣㄴㅡㄴㅇㅣㅈㅜㅇ	CHh I N EU N I J U NG
ㅊㅣㄹㅗㅇㅣㅆ	CHh I R O I t
ㅊㅣㅇㅏㄶㅇㅡㄴㅇㅏㅇㅣㅅㅡ	CHh I A N EU N A I S EU
ㅊㅣㅇㅣㄴㅇㅣㄹㅏㄱㅗㅁㅏㄹㅎㅐㅆㄷㅏ	CHh I I N I R A G O M A R H AE t D A
ㅊㅣㅈㅣㅇㅏㄶㅇㅡㄹㄱㅓㅅㅇㅣㄹㅏㄱㅗㅁㅏㄹㅎㅐㅆㄷㅏ	CHh I J I A N EU L G EO S I R A G O M A R H AE t D A
ㅊㅣㅎㅏㄴㅡㄴㅇㅗㅇㅕㅁ	CHh I A N EU N O iEO M
ㅊㅣㄹㅅㅣㅂ	CHh I L S I Ph
ㅊㅣㄹㅅㅣㅂㅇㅣㄹ	CHh I L S I B I L
ㅊㅣㅁㅇㅣㄴㅏㄴㅡㄴㄷㅡㅇ	CHh I M I N A N EU N D EU NG
ㅋㅓㄱ	Kh EO G
ㅋㅗㅇㅏㄱㅏㅇㅣㄷㅏㄹㅇㅣㅅㅣㅂㅅㅏㅇㅣㄹㅂㅜㅌㅓ	Kh O A G A I D A R I S I p S A I L B U Th EO
ㅋㅣㄱㅗㅇㅣㅆㄴㅡㄴㅇㅣㄴ	Kh I G O I N N EU N I N
ㅋㅣㄱㅣㅇㅟㅎㅐㅇㅣ	Kh I G I UE AE I
ㅋㅣㄴㅡㄴㅎㅕㄴ	Kh I N EU N iEO N
ㅋㅣㄹㅗㅎㅐㅆㄷㅏㄱㅗㅅㅏㅁㅅㅣㅂㅇㅣㄹ	Kh I R O AE t D A G O S A M S I B I L
ㅌㅏㄴㅏㄴㅡㄴㄱㅓㅅㅇㅡㄴㅇㅏㄴㅣㄷㅏ	Th A N A N EU N G EO S EU N A N I D A
ㅌㅏㅇㅣ	Th A I
ㅌㅐㄱㅏㅇㅣㄹ	Th AE G A I L
ㅌㅓㅅㅣㅈㅏㄱ	Th EO S I J A k
ㅌㅗㄹㅗㄱㅎㅏㄱㅣ	Th O R O Kh A G I
ㅌㅗㅎㅏㄱㅗㅇㅣㅆㄷㅏㄴㅡㄴㄱㅓㅅㅇㅣㄷㅏ	Th O A G O I t D A N EU N G EO S I D A
ㅌㅗㅇㄹㅕㅇㅇㅡㄴㅇㅣㄷㅡㄹㅇㅢ	Th O NG N iEO NG EU N I D EU R euI
ㅌㅗㅇㅅㅣㄴㅇㅡㄴㅇㅗㅇㅣㄹ	Th O NG S I N EU N O I N
ㅌㅗㅇㅎㅐㄱㅏㅈㅏㅇ	Th O NG H AE G A J A NG
ㅌㅗㅇㅎㅐㅎㅏㄴㅇㅣㄹ	Th O NG H AE A N I L
ㅌㅜㅈㅏㄱㅏㅇㅣㄹ	Th U J A G A I L
ㅌㅜㅈㅏㅇㅣㄹㅂㅐㄱ	Th U J A I L B AE G
ㅌㅜㅈㅏㅎㅏㅈㅣㅇㅏㄶㅇㅏㅆ	Th U J A A J I A N A t
ㅌㅡㄱㅏㅈㅓㅇㅂㅜ	Th EU G A J EO NG B U
ㅌㅡㄹㅡㄹㅇㅣㄹ	Th EU R EU R I L
ㅌㅡㅇㅔㅇㅣㅂ	Th EU E I M
ㅌㅣㄴㅏㄴㅡㄴ	Th I N A N EU N
ㅌㅣㅁㅇㅣㅇㅕㄴ	Th I M I iEO N
ㅍㅏㅎㅏㄴㅡㄴㄱㅓㅅㅇㅡㄹㅌㅗㅇㅎㅐ	Ph A A N EU N G EO S EU L Th O NG H AE
ㅍㅏㄴㄷㅏㄴㅎㅏㄹㄱㅓㅅㅇㅣㄹㅏㄱㅗㅁㅏㄹㅎㅐㅆㄷㅏ	Ph A N D A N A L G EO S I R A G O M A R H AE t D A
ㅍㅏㄴㅇㅣㅇㅗㄴㅡㄴㅇㅣㅅㅣㅂㅇㅠㄱ	Ph A N I O N EU N I S I B iU G
ㅍㅏㄹㅅㅣㅂㅇㅓㄱㅇㅝㄴㅇㅡㄹ	Ph A L S I B EO G uEO N EU L
ㅍㅏㄹㅇㅣㄹㅂㅜㅌㅓㅅㅣㅂㅇㅣㄹㅇㅣㄹ	Ph A R I L B U Th EO S I B I R I L
ㅍㅓㅅㅔㄴㅌㅡㄱㅏㄴㅡㄹㅇㅓㄴㅏㄴㅇㅣㄹ	Ph EO S E N Th EU G A N EU R EO N A N I L
ㅍㅓㅅㅔㄴㅌㅡㄹㅗㄴㅏ	Ph EO S E N Th EU R O N A
ㅍㅓㅅㅔㄴㅌㅡㄹㅡㄹㅇㅣㅈㅓㅁㅇㅣ	Ph EO S E N Th EU R EU R I J EO M I
ㅍㅔㅇㅣㅈㅣㄹㅗㄴㅡㄴ	Ph E I J I R O N EU N
ㅍㅗㄱㅣㅎㅏㄱㅣㄹㅗㅎㅏㅂ	Ph O G I A G I R O A B
ㅍㅜㄹ	Ph U R
ㅍㅣㅇㅏㄴㅡㄴㅅㅣㅂㅇㅗㅇㅣㄹ	Ph I A N EU N S I B O I L
ㅍㅣㅎㅏㅁㅕㄴㅅㅓ	Ph I A M iEO N S EO
ㅍㅣㅎㅐㅇㅣㄹ	Ph I AE I L
ㅎㅏㄱㅗㄱㅏㅈㅓㅇ	H A G O G A J EO NG
ㅎㅏㄱㅗㅅㅏㅁㅕㅇㅇㅣㅂㅜㅅㅏㅇ	H A G O S A M iEO NG I B U S A NG
ㅎㅏㄱㅗㅇㅣㄱㅏㅌ	A G O I G A Th
ㅎㅏㄱㅗㅇㅣㄹ	A G O I N
ㅎㅏㄱㅗㅇㅣㅆㄴㅡㄴㄷㅔㅇㅣㄹㅡㄹ	H A G O I N N EU N D E I R EU L
ㅎㅏㄱㅗㅇㅣㅆㄷㅏㄱㅗㅁㅏㄹㅎㅏㄱㅗㄱㅡㄹㅓㄴㅏ	A G O I t D A G O M A R H A G O G EU R EO N A
ㅎㅏㄱㅗㅇㅣㅆㅇㅡㄴㅏㅇㅏ	A G O I S EU N A A
ㅎㅏㄱㅗㅈㅣㄴㅏㄴㅇㅣㄹㅇㅝㄹ	A G O J I N A N I R uEO L
ㅎㅏㄱㅣㄹㅗㅇㅣㄹㅈㅓㅇㅇㅣ	H A G I R O I L J EO NG I
ㅎㅏㄱㅣㅇㅟㅎㅏㄴㄱㅓㅅㅇㅣㄹㅏㄱㅗㅁㅏㄹㅎㅐㅆㅇㅡㄴㅏ	H A G I UE A N G EO S I R A G O M A R H AE S EU N A
ㅎㅏㄱㅣㅇㅟㅎㅐㅇㅣㅅㅣㅂ	H A G I UE AE I S I M
ㅎㅏㄴㅏㄹㅏㄴㅡㄴㄱㅓㅅㅇㅣㄷㅏ	A N A R A N EU N G EO S I D A
ㅎㅏㄴㅡㄴㄱㅓㅅㅇㅡㄴㅇㅣ	A N EU N G EO S EU N I
ㅎㅏㄴㅡㄴㄱㅓㅅㅇㅣㅈㅣㅁㅏㄴ	A N EU N G EO S I J I M A N
ㅎㅏㄴㅡㄴㅅㅣㄱㅣㄴㅡㄴ	A N EU N S I G I N EU N
ㅎㅏㄴㅡㄴㅇㅣㄴㅅㅏㄹㅡㄹ	A N EU N I N S A R EU L
ㅎㅏㄴㅡㄴㅎㅏㄴㅍㅕㄴㅇㅣㄷㅡㄹㅇㅢ	A N EU N A N Ph iEO N I D EU R euI
ㅎㅏㄷㅏㄴㅡㄴ	A D A N EU N
ㅎㅏㄷㅗㄱㅡㅂ	H A D O G EU p
ㅎㅏㄹㅏㄱㅇㅡㄹ	A R A G EU L
ㅎㅏㅁㅕㄴㅅㅓㅇㅣㄹㅂㅜ	H A M iEO N S EO I L B U
ㅎㅏㅈㅣ	A J I
ㅎㅏㅈㅣㅇㅏㄶㅇㅏㅆㄷㅏ	A J I A N A t D A
ㅎㅏㅎㅏㅁㅕㄴㅅㅓ	H A A M iEO N S EO
ㅎㅏㄴㄱㅓㅅㅇㅡㄹㅗㅂㅗㄷㅗ	H A N G EO S EU R O B O D O
ㅎㅏㄴㄱㅓㅅㅇㅡㄴㅇㅏㄴㅣㄷㅏㄹㅏ	H A N G EO S EU N A N I D A R A
ㅎㅏㄴㄱㅓㅅㅇㅣㄹㅏㅁㅕㄴㅅㅓ	H A N G EO S I R A M iEO N S EO
ㅎㅏㄴㄱㅜㄱㅇㅡㄴㅇㅣㅂㅓㄴ	H A N G U G EU N I B EO N
ㅎㅏㄴㄱㅜㄱㅇㅣㅎㅐㅇㅚ	A N G U G I AE OE
ㅎㅏㄴㄷㅏㄴㅡㄴㄱㅓㅅㅇㅡㄹㅗ	A N D A N EU N G EO S EU R O
ㅎㅏㄴㅅㅏㄱㅓㄴ	A N S A G EO N
ㅎㅏㄴㅅㅏㅇㅏㄴ	H A N S A A N
ㅎㅏㄴㅇㅡㄴㅈㅣ	A N EU N J I
ㅎㅏㄴㅇㅣㅂㅐㄱ	A N I B AE Kh
ㅎㅏㄴㅇㅣㅎㅜ	H A N I U
ㅎㅏㄴㅇㅣㄹㅇㅣㅇㅏ	H A N I R I A
ㅎㅏㄴㅍㅕㄴㅇㅣㅅㅣㅂㅇㅣㄹㅇㅣㄹㅇㅗㅎㅜ	H A N Ph iEO N I S I B I R I R O U
ㅎㅏㄹ	A R
ㅎㅏㄹㄱㅓㅅㅇㅡㄹㅗㅎㅏㄱ	A L G EO S EU R O A k
ㅎㅏㄹㄱㅓㅅㅇㅣㄹㅏㄱㅗㅇㅣㅅㅏㅇㅓㅂ	A L G EO S I R A G O I S A EO B
ㅎㅏㄹㅅㅜㅇㅓㅄ	H A L S U EO p
ㅎㅏㄹㅅㅜㅇㅣㅆㄷㅏㄱㅗㅇㅣ	A L S U I t D A G O I
ㅎㅏㄹㅇㅣㄴㅇㅡㄹㅂㅏㄷㅇㅏ	A R I N EU L B A D A
ㅎㅐㄱㅏㅇㅜ	H AE G A U
ㅎㅐㅅㅏㅇㅓㅂ	AE S A EO p
ㅎㅐㅅㅣㅂㅅㅏㅈㅓㅁ	H AE S I p S A J EO M
ㅎㅐㅇㅣㄷㅏㄹ	H AE I D A N
ㅎㅐㅇㅣㅅㅣㅂㅇㅣㄹㅇㅣㄹ	AE I S I B I R I R
ㅎㅐㅇㅣㅆ	AE I t
ㅎㅐㅈㅜㄴㅡㄴㄱㅓㅅ	H AE J U N EU N G EO t
ㅎㅐㅈㅣㅂㅜㄴㅇㅡㄹ	AE J I B U N EU R
ㅎㅐㅎㅏㅈㅣㅇㅏㄶㅇㅡ	AE A J I A N EU
ㅎㅐㅆㄷㅏㄱㅗㅁㅏㄹㅎㅏㄱㅗ	H AE t D A G O M A R H A G O
ㅎㅐㅆㄷㅏㄱㅗㅈㅓㅇ	AE t D A G O J EO NG
ㅎㅐㅆㄷㅏㅁㅕ	AE t D A M iEO
ㅎㅐㅆㅇㅡㄴㅏㅇㅣㄴㅎㅏ	AE S EU N A I N A
ㅎㅐㅆㅇㅡㅁㅕㅇㅣㅅㅣㅂㅇㅣㄹ	H AE S EU M iEO I S I B I R
ㅎㅕㄴㅈㅐㅇㅣㅅㅣㅂㅅㅏㅁ	iEO N J AE I S I p S A M
ㅎㅗㄱㅏㄷㅡㄹㅇㅡㄴ	O G A D EU R EU N
ㅎㅗㅅㅏㄷㅡㄹㅇㅡㄹ	O S A D EU R EU L
ㅎㅗㅎㅏㄱㅗㅇㅣㅆㄴㅡㄴㄱㅓㅅㅇㅡㄹㅗㅂㅜㄴ	O A G O I N N EU N G EO S EU R O B U N
ㅎㅘㅎㅏㄱㅗㄱㅡ	oA A G O G EU
ㅎㅘㅎㅏㄱㅣㅇㅓ	oA A G I EO
ㅎㅘㅎㅏㅁㅕ	oA A M iEO
ㅎㅜㅅㅏㅁㅅㅣㅂㅇㅣㄹ	U S A M S I B I L
ㅎㅡㄹ	EU L
ㅎㅣㄱㅗㅇㅣㄹㅂㅗㄴ	I G O I L B O N
ㅎㅣㅈㅣㅇㅏㄶㅇㅏㅆㄷㅏ	I J I A N A t D A
2ㄴㅕㄴㅇㅡㄹ	I N iEO N EU L
ㅇㅏㅇㅣㅈㅔㄴㅅㅡㅌㅏㅌㅡㅌㅡㄱㅅㅏㄴㅡㄴ	A I J E N S EU Th A Th EU Th EU k SS A N EU N
ㅇㅏㄱㅜㄴㅇㅡㄹㅗ	A G U N EU R O
ㅇㅏㅁㅏㅊㅜㅇㅓㄷㅡㄹㄷㅗ	A M A CHh U EO D EU L D O
ㅇㅏㄵㅎㅣㄴ	A N I N
ㅇㅏㄶㄴㅡㄴㅑㄴㅡㄴ	A N N EU N iA N EU N
ㅇㅏㄴㅍㅏㄲㅇㅣㄷㅏ	A N Ph A GG I D A
ㅇㅏㅍㅇㅔㅅㅓ	A Ph E S EO
ㅇㅏㄹㅏㅂㅣㅇㅏㅇㅘ	A R A B I A oA
ㅇㅏㅇㅜㅇㅅㅏㄴ	A U NG S A N
ㅈㅏㅈㅣㄴ	J A J I N
ㅈㅐㄱㅐㅇㅔ	J AE G AE E
ㅈㅐㅂㅓㄹ	J AE B EO L
ㅈㅐㅌㅏㅇㅇㅣㅇㅓㅆㄷㅓㄴ	J AE Th A NG I EO t DD EO N
ㅈㅏㄱㅡㅁㅅㅣㅈㅏㅇㅇㅡㄴ	J A G EU M S I J A NG EU N
ㅈㅏㄹㅁㅗㅅㅎㅏㄱㅗ	J A L M O Th A G O
ㅈㅏㄴㅊㅐㅇㅇㅣㅁㅏㄴ	J A N CHh AE NG I M A N
ㅈㅏㅇㄱㅘㄴㅇㅚㅇㅔ	J A NG G oA N OE E
ㅈㅏㅇㄷㅏㄴㄱㅣ	J A NG D A N G I
ㅈㅏㅂㅗㄴㄱㅡㅁㅇㅡㄴ	J A B O N G EU M EU N
ㅈㅏㅅㅔㄴㅡㄴ	J A S E N EU N
ㅈㅏㅇㅝㄴㅇㅣ	J A uEO N I
ㅉㅏㄴㅐㄱㅣㅇㅔ	JJ A N AE G I E
ㅈㅔㅈㅏㄷㅡㄹ	J E J A D EU L
ㅈㅔㅎㅏㄴㄷㅐㅅㅏㅇㅎㅘㄱㄷㅐ	J E A N D AE S A NG H oA k DD AE
ㅈㅔㄱㅗㅎㅏㄴㅡㄴ	J E G O A N EU N
ㅈㅔㅇㅚㄷㅙㅆㄷㅏㄱㅗ	J E OE D O AE t DD A G O
ㅈㅓㄱㄴㅏㄹㅏㅎㅏㄱㅔ	J EO NG N A R A A G E
ㅈㅓㄻㅇㅡㄴㅊㅡㅇㅇㅡㄹ	J EO L M EU N CHh EU NG EU L
ㅈㅓㅁㅍㅗㅇㅢ	J EO M Ph O euI
ㅈㅓㄴㅊㅔㅅㅣㄹㅇㅓㅂㄹㅠㄹㅇㅣ	J EO N CHh E S I R EO M N iU R I
ㅈㅓㅇㅊㅏㄱㅈㅣㅇㅔ	J EO NG CHh A k JJ I E
ㅈㅓㅇㅊㅣㄴㅏ	J EO NG CHh I N A
ㅈㅓㅇㄱㅣㄱㅜㄱㅎㅚㄹㅡㄹ	J EO NG G I G U Kh OE R EU L
ㅈㅓㅇㅂㅣㄹㅏㄴㅡㄴ	J EO NG B I R A N EU N
ㅈㅓㅇㅂㅜㅇㅕㄷㅏㅇㅇㅡㄹㅗㅅㅓㄴㅡㄴ	J EO NG B U iEO D A NG EU R O S EO N EU N
ㅈㅓㅇㄷㅏㅇㅎㅚㄱㅖㅂㅣㄹㅗ	J EO NG D A NG H OE G iE B I R O
ㅈㅓㄴㅎㅚㅇㅇㅡㄹ	J EO N OE NG EU L
ㅈㅓㄴㄱㅜㄱㅎㅘㄷㅙㄱㅏㄴㅡㄴ	J EO N G U Kh oA D O AE G A N EU N
ㅈㅓㄴㅁㅜㄴㅅㅓㅇㄱㅘ	J EO N M U N S EO NG G oA
ㅈㅓㄴㄹㅕㄱㅅㅜㅇㅛㄷㅗ	J EO N N iEO k SS U iO D O
ㅈㅓㄴㅌㅗㅇㅇㅢ	J EO N Th O NG euI
ㅈㅓㅂㅅㅜㅅㅣㅋㅣㄴㅡㄴ	J EO p SS U S I Kh I N EU N
ㅈㅔㄷㅗㅎㅘㅎㅏㄴㅡㄴ	J E D O oA A N EU N
ㅈㅡㅇㄱㅝㄴㄱㅓㄹㅐㅂㅓㅂ	J EU NG G uEO N G EO R AE B EO p
ㅊㅏㅈㅇㅡㄹ	CHh A J EU L
ㅊㅐㄱㅝㄴㅅㅣㅈㅏㅇㅇㅣ	CHh AE G uEO N S I J A NG I
ㅊㅏㄱㅘㄴㄱㅡㅂ	CHh A G oA N G EU p
ㅊㅏㅁㅇㅕㅁㅣㄴㅈㅜㅅㅏㅎㅚㅅㅣㅁㅣㄴㅇㅕㄴㄷㅐㄷㅗ	CHh A M iEO M I N J U S A OE S I M I N iEO N D AE D O
ㅊㅏㄴㅅㅓㅇ	CHh A N S EO NG
ㅊㅔㅈㅔㄱㅐㅍㅕㄴ	CHh E J E G AE Ph iEO N
ㅊㅓㄱㅈㅣㄱㅗ	CHh EO k JJ I G O
ㅊㅓㄴㅈㅣㄹㅗ	CHh EO N J I R O
ㅊㅓㅇㅇㅝㄴㅎㅏㄹ	CHh EO NG uEO N A L
ㅊㅓㄴㅇㅕㄴㄱㅏㅅㅡㅂㅏㄹㅈㅓㄴㅅㅗㄹㅗ	CHh EO N iEO N G A S EU B A L J EO N S O R O
ㅊㅡㄱㄱㅡㄴㄷㅡㄹㄷㅗ	CHh EU k GG EU N D EU L D O
ㅊㅣㄹㅂㅐㄱㅅㅣㅂㅊㅣㄹㅇㅝㄴㅇㅡㄹㅗ	CHh I L B AE k SS I p CHh I R uEO N EU R O
ㅊㅣㄹㅇㅝㄹㅅㅣㅂㅇㅗㅇㅣㄹ	CHh I R uEO L S I B O I L
ㅊㅣㄴㅂㅜㄱㄱㅘ	CHh I N B U k GG oA
ㅊㅚㅊㅓㅁㄷㅏㄴ	CHh OE CHh EO M D A N
ㅊㅚㄷㅐㄱㅣㅇㅓㅂㅇㅡㄴ	CHh OE D AE G I EO B EU N
ㅊㅗㅇㅈㅐㅇㅢ	CHh O NG J AE euI
ㅊㅗㅇㅅㅓㄴㄷㅗ	CHh O NG S EO N D O
ㅊㅜㅈㅓㅇㄷㅚㄴㄷㅏㄴㅡㄴ	CHh U J EO NG D OE N D A N EU N
ㅊㅜㄱㅈㅓㄱㅇㅡㄹㅗ	CHh U k JJ EO G EU R O
ㅊㅜㄹㅂㅏㄹㅎㅏㄱㅗ	CHh U L B A R H A G O
ㅊㅜㅇㄴㅏㅁㅇㅢ	CHh U NG N A M euI
ㅊㅟㅈㅣㄴㅏ	CHh UE J I N A
ㅈㅣㅈㅓㄱㅎㅏㄴㄷㅏ	J I J EO Kh A N D A
ㅈㅣㅇㅔㄴㅍㅣ	J I E N Ph I
ㅈㅣㄱㅡㅁㄲㅏㅈㅣㅇㅢ	J I G EU M GG A J I euI
ㅈㅣㄱㅍㅏㄴㅊㅔㅈㅔ	J I k Ph A N CHh E J E
ㅈㅣㄹㅅㅓ	J I L S EO
ㅈㅣㄴㅈㅓㅇㅅㅣㅋㅣㄴㄷㅏㄴㅡㄴ	J I N J EO NG S I Kh I N D A N EU N
ㅈㅣㄴㅣㄴㄷㅏㄴㅡㄴ	J I N I N D A N EU N
ㅈㅣㅂㅐㅎㅏㄴ	J I B AE A N
ㅈㅣㅂㅈㅜㅇㄱㅘ	J I p JJ U NG G oA
ㅈㅣㅂㄷㅏㄴㅅㅣㅇㅟㄹㅡㄹ	J I p DD A N S I UE R EU L
ㅈㅣㅅㅗㄱㅎㅏㄹㅈㅣ	J I S O Kh A L J I
ㅈㅣㅇㅝㄴㅎㅐㅆㅇㅡㅁㅕ	J I uEO N AE SS EU M iEO
ㅈㅣㅇㅕㄱㅂㅗㄴㅂㅜㄹㅡㄹ	J I iEO k BB O N B U R EU L
ㅈㅗㅈㅣㄱㄱㅐㅍㅕㄴㄱㅘ	J O J I k GG AE Ph iEO N G oA
ㅈㅗㄱㅓㄴ	J O G EO N
ㅈㅗㄴㅇㅓㅁㅅㅓㅇㅇㅡㄹ	J O N EO M S EO NG EU L
ㅈㅗㅇㅅㅏㅎㅏㄹ	J O NG S A A L
ㅈㅗㅅㅓㅇㅈㅔㄷㅗㄱㅏ	J O S EO NG J E D O G A
ㅈㅜㅈㅏㅇㅎㅏㄹ	J U J A NG H A L
ㅈㅜㅇㅣㄴㅇㅣㄷㅏㄴㅡㄴ	J U I N I D A N EU N
ㅈㅜㄹㅇㅣㄱㅗ	J U R I G O
ㅈㅜㅇㅇㅏㅇㅈㅣㅂㄱㅝㄴㅎㅘㅎㅏㄴ	J U NG A NG J I p GG uEO N oA A N
ㅈㅜㅇㄱㅏㄴㅇㅔㅅㅓ	J U NG G A N E S EO
ㅈㅜㅇㅍㅗㄱㅇㅡㄹㅗ	J U NG Ph O G EU R O
ㅈㅜㅇㅅㅗㄱㅣㅇㅓㅂㅇㅣ	J U NG S O G I EO B I
ㅈㅜㄴㄱㅗㅇㅎㅐ	J U N G O NG H AE
ㅈㅜㄹㅠㄹㅡㄹ	J U R iU R EU L
ㅈㅜㅇㅕㄱㄷㅡㄹㅇㅣ	J U iEO k DD EU R I
ㅇㅔㅇㅣㅌㅏㄴ	E I Th A N
ㅇㅓㅊㅓㄱㅜㄴㅣ	EO CHh EO G U N I
ㅇㅓㅁㅓㄴㅣㅇㅣㄴ	EO M EO N I I N
ㅇㅓㄴㄹㅗㄴㄷㅏㄴㅊㅔㄷㅗ	EO N N O N D A N CHh E D O
ㅇㅓㅄㅇㅓㅈㅣㄴㄷㅏ	EO p SS EO J I N D A
ㅇㅓㄹㅕㅂㄱㅗ	EO R iEO p GG O
ㅇㅔㄹㅡㅂㅏㅋㅏㄴㅊㅗㅇㄹㅣㄴㅡㄴ	E R EU B A Kh A N CHh O NG N I N EU N
ㅇㅡㄴㅎㅐㅇㅇㅢ	EU N AE NG euI
ㅎㅐㅈㅝㅆㄴㅡㄴㄷㅔ	H AE J uEO N N EU N D E
ㅎㅐㄱㅕㄹㅈㅓㅇㅊㅣㅇㅢ	H AE G iEO L J EO NG CHh I euI
ㅎㅐㅇㅂㅗㄱㅎㅏㄴ	H AE NG B O Kh A N
ㅎㅐㅇㅚㄱㅛㅍㅗ	H AE OE G iO Ph O
ㅎㅐㅅㅗㄹㅡㄹ	H AE S O R EU L
ㅎㅏㄱㅔㅆㄴㅡㄴㄱㅏ	H A G E N N EU N G A
ㅎㅏㄱㅅㅏㄹㄷㅏㅇㅎㅏㄱㅗ	H A k SS A L D A NG H A G O
ㅎㅏㅁㅕㄴㅅㅓㄷㅗ	H A M iEO N S EO D O
ㅎㅏㄴㅇㅡㄴㅇㅣ	H A N EU N I
ㅎㅏㄴㄱㅏㅈㅣㄴㅡㄴ	H A N G A J I N EU N
ㅎㅏㄴㄱㅜㄱㄱㅕㅇㅈㅔㅇㅢ	H A N G U k GG iEO NG J E euI
ㅎㅏㄴㅍㅜㄹㅇㅣㅅㅣㄱ	H A N Ph U R I S I k
ㅎㅏㅂㅏㄴㄱㅣㅇㅔㄴㅡㄴ	H A B A N G I E N EU N
ㅎㅏㅂㅇㅢㅎㅐㅆㄷㅏ	H A B euI AE t DD A
ㅎㅏㅇㅘㅇㅣ	H A oA I
ㅎㅓㅍㅜㅇㅇㅣㄹㅏㄴㅡㄴ	H EO Ph U NG I R A N EU N
ㅎㅡㄹㄹㅣㄴ	H EU L L I N
ㅎㅣㅁㄴㅐㄹㅏㄴㅡㄴ	H I M N AE R A N EU N
ㅎㅚㄱㅖㅂㅓㅂㅇㅣㄴㅁㅏㄴㅇㅣ	H OE G iE B EO B I N M A N I
ㅎㅚㅇㅝㄴㄱㅜㄱㄱㅏㅇㅣㅂㅇㅔ	H OE uEO N G U k GG A I B E
ㅎㅗㅇㅋㅗㅇㅅㅏㅁㅜㅅㅗ	H O NG Kh O NG S A M U S O
ㅎㅜㅈㅣㄴㄱㅣㅇㅓㅇㅘ	H U J I N G I EO oA
ㅎㅜㅂㅗㅇㅔ	H U B O E
ㅎㅘㅎㅐㄴㅑ	H oA AE N iA
ㅎㅘㄱㅂㅗㅎㅏㄴㄷㅏㄴㅡㄴ	H oA k BB O A N D A N EU N
ㅎㅘㄱㅛㄷㅗㅇㅊㅏㅇㅅㅐㅇㄲㅣㄹㅣㅇㅢ	H oA G iO D O NG CHh A NG S AE NG GG I R I euI
ㅎㅘㄴㅈㅏㅂㅏㄹㅅㅐㅇ	H oA N J A B A L S AE NG
ㅎㅘㄴㄱㅕㅇㅂㅜㅇㅘ	H oA N G iEO NG B U oA
ㅎㅘㅇㅑㄱㄱㅗㄹㅗ	H oA iA k GG O R O
ㅎㅕㄴㅇㅏㄴㅇㅣㅈㅣㅁㅏㄴ	H iEO N A N I J I M A N
ㅎㅕㅇㅅㅓㅇㄷㅚㄱㅗ	H iEO NG S EO NG D OE G O
ㅎㅕㄴㅅㅣㄹㅇㅣㄹㅏㄴ	H iEO N S I R I R A N
ㅎㅕㅂㄹㅕㄱㄱㅛㅅㅜㄹㅗ	H iEO M N iEO k GG iO S U R O
ㅎㅢㅅㅐㅇㄷㅚㅈㅣ	H euI S AE NG D OE J I
ㅇㅣㅈㅓㄴㅇㅔㄴㅡㄴ	I J EO N E N EU N
ㅇㅣㅊㅡㅎㅏㅋㅡㅇㅢ	I CHh EU A Kh EU euI
ㅇㅣㅎㅐㅎㅐㅆㄷㅏ	I AE AE t DD A
ㅇㅣㄱㅏㅇㅎㅢ	I G A NG H euI
ㅇㅣㄱㅘㄷㅐㅇㅘ	I G oA D AE oA
ㅇㅣㄹㅊㅓㄴㅍㅕㅇ	I L CHh EO N Ph iEO NG
ㅇㅣㄹㅇㅡㄴ	I R EU N
ㅇㅣㄹㄱㅓㄴㅏ	I L G EO N A
ㅇㅣㄹㄴㅕㄴㅇㅣ	I N N iEO N I
ㅇㅣㄹㅂㅏㄴㅎㅚㄱㅖㅇㅢ	I L B A N OE G iE euI
ㅇㅣㄹㅂㅗㄴㅁㅣㄴㅈㅜㅇㅇㅢ	I L B O N M I N J U NG euI
ㅇㅣㄹㄷㅏㄹㄹㅓㅇㅔㅅㅓ	I L D A L L EO E S EO
ㅇㅣㅁㅣㄴㅈㅏㄷㅡㄹㅇㅢ	I M I N J A D EU R euI
ㅇㅣㅁㄷㅐㅇㅜㄴㅇㅕㅇㅈㅜㅇㅇㅣㅁㅕ	I M D AE U N iEO NG J U NG I M iEO
ㅇㅣㄴㅈㅗㅇㅈㅓㄱ	I N J O NG J EO k
ㅇㅣㄴㅁㅐㄱㅈㅜㅇㅅㅣㅁㅇㅢ	I N M AE k JJ U NG S I M euI
ㅇㅣㄴㅅㅏㅇㅇㅡㄴ	I N S A NG EU N
ㅇㅣㄴㅌㅔㄹㅣㅇㅓㄱㅏ	I N Th E R I EO G A
ㅇㅣㅂㅐㄱㅅㅏㅅㅣㅂㅅㅏ	I B AE k SS A S I p SS A
ㅇㅣㅂㅎㅏㄱㅎㅏㄴ	I Ph A Kh A N
ㅇㅣㅂㅇㅝㄴㅊㅣㄹㅛㄹㅡㄹ	I B uEO N CHh I R iO R EU L
ㅇㅣㄹㅜㅇㅓㅈㅣㄱㅣㄴㅡㄴ	I R U EO J I G I N EU N
ㅇㅣㅅㅔㄷㅡㄹㅇㅡㄴ	I S E D EU R EU N
ㅇㅣㅅㅣㅂㅁㅏㄴㅇㅣㅊㅓㄴㅇㅠㄱㅂㅐㄱㅅㅏㅁㅅㅣㅂㅁㅕㅇㅇㅡㄹ	I S I M M A N I CHh EO N iU k BB AE k SS A M S I M M iEO NG EU L
ㅇㅣㅆㅇㅓㅅㅓㄴㅡㄴ	I SS EO S EO N EU N
ㅇㅣㅆㄷㅗㄹㅗㄱ	I t DD O R O k
ㅇㅣㄷㅗ	I D O
ㅇㅣㅇㅛㅇㅎㅏㅇㅕ	I iO NG H A iEO
ㄱㅏㅈㅣㄴㄷㅏ	G A J I N D A
ㄱㅐㅊㅓㄴㅈㅜㅂㅕㄴㅇㅡㄹ	G AE CHh EO N J U B iEO N EU L
ㄱㅐㅇㅣㄴㅇㅕㄴㅅㅓㄹㅎㅚㄹㅡㄹ	G AE I N iEO N S EO R H OE R EU L
ㄱㅐㅂㅏㄹㄴㅗㄴㄹㅣㅇㅔ	G AE B A N N O N N I E
ㄱㅐㅅㅓㄹㄱㅣㄴㅕㅁㅅㅣㄱㅇㅔㅅㅓㄴㅡㄴ	G AE S EO L G I N iEO M S I G E S EO N EU N
ㄱㅏㅇㅣㅂㅁㅜㄴㅈㅔ	G A I M M U N J E
ㄱㅏㄱㅕㄱㅈㅜㅇ	G A G iEO k JJ U NG
ㄱㅏㅁㅈㅏㄹㅗ	G A M J A R O
ㄱㅏㅁㅅㅗㄴㅡㄴ	G A M S O N EU N
ㄱㅏㄴㅡㅇㅎㅏㄷㅏㄴㅡㄴ	G A N EU NG H A D A N EU N
ㄱㅏㅇㅎㅘㅎㅏㅈㅣ	G A NG H oA A J I
ㄱㅏㅇㄹㅕㄱㅎㅏㄱㅔ	G A NG N iEO Kh A G E
ㄱㅏㄴㅂㅜㄷㅡㄹㅇㅔ	G A N B U D EU R E
ㄱㅏㄹㅕㄴㅐㄱㅣㄷㅗ	G A R iEO N AE G I D O
ㄱㅏㅌㅇㅣ	G A Th I
ㄱㅓㅊㅕㅇㅑ	G EO CHh iEO iA
ㄱㅓㄹㄹㅕㅇㅘㅆㅈㅣㅁㅏㄴ	G EO L L iEO oA t JJ I M A N
ㄱㅓㄴㅈㅓㄴㅎㅏㅈㅣ	G EO N J EO N A J I
ㄱㅓㄴㅅㅓㄹㅎㅏㄹㅕ	G EO N S EO R H A R iEO
ㄱㅓㄹㅐㅈㅓㄴㅍㅛㅇㅔㅁㅏㄴ	G EO R AE J EO N Ph iO E M A N
ㄱㅓㅅㅇㅣㄱㅔㅆㄴㅡㄴㄱㅏ	G EO S I G E N N EU N G A
ㄱㅓㄷㅡㄹㅇㅓㅆㄷㅏ	G EO D EU R EO t DD A
ㄱㅡㄱㄱㅘ	G EU k GG oA
ㄱㅡㅁㅈㅣㄷㅚㄴ	G EU M J I D OE N
ㄱㅡㅁㅇㅠㅇㄱㅣㄱㅘㄴㅇㅔㅅㅓ	G EU M iU NG G I G oA N E S EO
ㄱㅡㄴㅁㅜㅎㅏㄷㅓㄴ	G EU N M U A D EO N
ㄱㅡㅂㅗㄷㅏㄴㅡㄴ	G EU B O D A N EU N
ㄱㅡㄹㅓㅁㅇㅔㄷㅗ	G EU R EO M E D O
ㄱㅡㄷㅗㅇㅇㅏㄴㅇㅔ	G EU D O NG A N E
ㅋㅏㅅㅡㅌㅡㄹㅡㄹ	Kh A S EU Th EU R EU L
ㅋㅓㄴㅌㅔㅇㅣㄴㅓ	Kh EO N Th E I N EO
ㅋㅣㅍㅗㅇㅣㄴㅌㅡㄷㅏ	Kh I Ph O I N Th EU D A
ㄱㅣㅇㅏ	G I A
ㄱㅣㅈㅗㄴ	G I J O N
ㄱㅣㅇㅓㅂㄱㅕㄹㅎㅏㅁㅇㅡㄹ	G I EO p GG iEO R H A M EU L
ㄱㅣㄱㅘㄴㄱㅘ	G I G oA N G oA
ㄱㅣㅁㅇㅣㄹㅇㅠㄴ	G I M I R iU N
ㄱㅣㅁㅇㅕㅇㅅㅏㅁㅈㅓㅇㅂㅜ	G I M iEO NG S A M J EO NG B U
ㄱㅣㅍㅇㅣㄱㅏ	G I Ph I G A
ㄱㅣㅅㅗㅎㅐㅆㄷㅏ	G I S O AE t DD A
ㄱㅣㄷㅏㄹㅕㅆㅇㅓ	G I D A R iEO SS EO
ㄲㅓㄹㅣㄱㅗ	GG EO R I G O
ㄲㅗㅈㅣㅂㅇㅓㄱㅏㅁㅕ	GG O J I B EO G A M iEO
ㄱㅗㅊㅣㅎㅕㄴㅇㅢ	G O CHh I iEO N euI
ㄱㅗㄱㅗㅎㅏㄱㅈㅓㄱ	G O G O A k JJ EO k
ㄱㅗㅇㅈㅓㅇㄱㅓㄹㅐㅂㅓㅂㅅㅏㅇ	G O NG J EO NG G EO R AE B EO p SS A NG
ㄱㅗㅇㅎㅓㄴㅎㅏㄴㄷㅏㄴㅡㄴ	G O NG H EO N A N D A N EU N
ㄱㅗㅇㄱㅡㅂㄷㅙ	G O NG G EU p DD O AE
ㄱㅗㅇㅍㅛㅎㅏㄴ	G O NG Ph iO A N
ㄱㅗㅇㅌㅗㅇ	G O NG Th O NG
ㄱㅗㅂㅈㅣ	G O p JJ I
ㄱㅗㅅㅗㄱㄷㅗㄹㅗㅇㅘ	G O S O k DD O R O oA
ㄱㅜㅊㅏㅎㅏㄱㅔ	G U CHh A A G E
ㄱㅜㅎㅕㄴㄷㅚㄹ	G U iEO N D OE L
ㄱㅜㄱㅈㅔㅂㅓㅂ	G U k JJ E B EO p
ㄱㅜㄱㄱㅏㅇㅔㅅㅓㄴㅡㄴ	G U k GG A E S EO N EU N
ㄱㅜㄱㅁㅣㄴㅎㅚㅇㅢㅊㅡㄱㅇㅢ	G U NG M I N OE euI CHh EU G euI
ㄱㅜㄱㄴㅐㄱㅡㅁㅇㅠㅇㅅㅣㅈㅏㅇㅇㅣ	G U NG N AE G EU M iU NG S I J A NG I
ㄱㅜㄹㅈㅓㄹㄷㅚㄴ	G U L J EO L D OE N
ㄱㅜㄴㅇㅣㄴㄷㅡㄹㅇㅡㄴ	G U N I N D EU R EU N
ㄱㅜㄴㅅㅗㅈㅓㅇㅍㅏㄷㅡㄹ	G U N S O J EO NG Ph A D EU L
ㄱㅜㅅㅓㅇㅎㅏㅁㅕ	G U S EO NG H A M iEO
ㄱㅜㅅㅣㅂㅅㅏㅁㄴㅕㄴㅂㅜㅌㅓㅅㅏㄴㅕㄴ	G U S I p SS A M N iEO N B U Th EO S A N iEO N
ㄱㅘㅈㅔㅇㅔ	G oA J E E
ㄱㅘㄴㅊㅏㄹㅎㅏㅁㅕㄴ	G oA N CHh A R H A M iEO N
ㄱㅘㄴㅎㅐㅇㅇㅡㄹㅗ	G oA N AE NG EU R O
ㄱㅘㄴㅂㅕㄴㄷㅏㄴㅊㅔㄱㅏ	G oA N B iEO N D A N CHh E G A
ㄱㅘㄴㅅㅏㅇㅢ	G oA N S A euI
ㄱㅝㄴㅎㅏㅇㅔㅅㅓ	G uEO N A E S EO
ㄱㅟㄱㅜㄱㅎㅐ	G UE G U Kh AE
ㄱㅕㄲㅇㅡㅁㅕㄴㅅㅓ	G iEO GG EU M iEO N S EO
ㄱㅕㄹㅎㅏㅂㅇㅣㄹㅏㄴㅡㄴ	G iEO R H A B I R A N EU N
ㄱㅕㄹㄷㅏㄴㅇㅡㄹㅗ	G iEO L D A N EU R O
ㄱㅕㅇㅈㅔㅈㅏㅇㅝㄴㅁㅏㅈㅓ	G iEO NG J E J A uEO N M A J EO
ㄱㅕㅇㅈㅔㅁㅜㄴㅈㅔㅇㅔㅁㅏㄴ	G iEO NG J E M U N J E E M A N
ㄱㅕㅇㅈㅔㅌㅡㄱㄱㅜㄹㅡㄹ	G iEO NG J E Th EU k GG U R EU L
ㄱㅕㅇㅎㅗㅅㅣㄹㅇㅡㄴ	G iEO NG H O S I R EU N
ㄱㅕㅇㅂㅣㅎㅚㅅㅏㄷㅡㄹㅇㅣ	G iEO NG B I OE S A D EU R I
ㄱㅕㅇㅇㅕㅇ	G iEO NG iEO NG
ㄱㅕㅇㅜㄹㄱㅘ	G iEO U L G oA
ㄱㅛㅊㅔㅎㅏㄴㅡㄴ	G iO CHh E A N EU N
ㄱㅛㅅㅜㄷㅡㄹㅇㅡㄴ	G iO S U D EU R EU N
ㄱㅛㅇㅠㄱㅇㅟㅇㅝㄴㅎㅚ	G iO iU G UE uEO N OE
ㄱㅠㄴㅎㅕㅇㅇㅖㅅㅏㄴ	G iU N iEO NG iE S A N
ㅁㅏㅈㅜㅊㅣㄹ	M A J U CHh I L
ㅁㅐㄴㅊㅔㅅㅡㅌㅓㅇㅢ	M AE N CHh E S EU Th EO euI
ㅁㅏㄱㅏㅁㅇㅣㄹㅇㅣㄴ	M A G A M I R I N
ㅁㅏㄺㅇㅡㄴ	M A L G EU N
ㅁㅏㅇㅎㅐㅂㅓㄹㅣㄹ	M A NG H AE B EO R I L
ㅁㅏㄴㄴㅏㄹ	M A N N A L
ㅁㅏㄹㅡㄴ	M A R EU N
ㅁㅏㅌㄱㅕㄷㅜㄴㅡㄴ	M A t GG iEO D U N EU N
ㅁㅓㄹㅌㅣㅅㅛㅂ	M EO L Th I S iO p
ㅁㅣㄲㅡㄹㅓㅈㅣㄷㅡㅅ	M I GG EU R EO J I D EU t
ㅁㅣㄹㅇㅓㄴㅐㄹㅕㄴㅡㄴ	M I R EO N AE R iEO N EU N
ㅁㅣㄴㅊㅓㅂㅅㅓㅇㅇㅣ	M I N CHh EO p SS EO NG I
ㅁㅣㄴㅈㅜㄱㅜㄱㅁㅣㄴㄷㅗㅇㅁㅐㅇㅇㅡㄴ	M I N J U G U NG M I N D O NG M AE NG EU N
ㅁㅣㄴㅅㅓㄴㄷㅐㅌㅗㅇㄹㅕㅇㅇㅔㄱㅔㄴㅡㄴ	M I N S EO N D AE Th O NG N iEO NG E G E N EU N
ㅁㅣㄷㅡㄴㅏㅍㅗㄹㅡㄹㅏㄴㅡㄴ	M I D EU N A Ph O R EU R A N EU N
ㅁㅗㄱㅈㅓㄱㅈㅣㅇㅣㄴ	M O k JJ EO k JJ I I N
ㅁㅗㄹㄹㅏㅆㄷㅏㄱㅗ	M O L L A t DD A G O
ㅁㅗㅅㅐㄱㅎㅏㄹㅕㄴㅡㄴ	M O S AE Kh A R iEO N EU N
ㅁㅗㅅㄷㅙ	M O t DD O AE
ㅁㅜㅎㅏㄴㄱㅕㅇㅈㅐㅇㅅㅣㄷㅐ	M U A N G iEO NG J AE NG S I D AE
ㅁㅜㄹㅇㅡㄹ	M U R EU L
ㅁㅜㄹㅇㅢㄹㅡㄹ	M U R euI R EU L
ㅁㅜㄴㅓㄸㅡㄹㅣㄱㅣㄴㅡㄴ	M U N EO DD EU R I G I N EU N
ㅁㅜㅂㅜㄴㅂㅕㄹㅎㅏㄴ	M U B U N B iEO R H A N
ㅁㅜㄷㅎㅕ	M U Th iEO
ㅁㅕㄴㅈㅓㄱㅇㅡㄴ	M iEO N J EO G EU N
ㅁㅕㅇㅇㅖㅇㅘ	M iEO NG iE oA
ㄴㅐㅇㅔㄴㅡㄴ	N AE E N EU N
ㄴㅐㅇㄷㅗㅇㅅㅣㄱㅍㅜㅁㅇㅡㄹ	N AE NG D O NG S I k Ph U M EU L
ㄴㅐㄹㅕㅈㅣㄹㅈㅣ	N AE R iEO J I L J I
ㄴㅏㅎㅡㄹㄱㅏㄴ	N A EU L G A N
ㄴㅏㄹㄹㅕㅂㅓㄹㅕㅆㅇㅓㅆㄷㅏ	N A L L iEO B EO R iEO SS EO t DD A
ㄴㅏㅁㄴㅕㅂㅣㅇㅠㄹㅇㅡㄴ	N A M N iEO B I iU R EU N
ㄴㅏㄴㄱㅘㄴㄱㅘ	N A N G oA N G oA
ㄴㅏㄹㅏㅇㅔㅅㅓㄷㅗ	N A R A E S EO D O
ㄴㅏㅌㅏㄴㅏㄴㅡㄴ	N A Th A N A N EU N
ㄴㅓㅁㅇㅓㅅㅓㄴ	N EO M EO S EO N
ㄴㅡㄲㅕㅆㄷㅏㄱㅗ	N EU GG iEO t DD A G O
ㄴㅗㅈㅓㅇㅇㅔ	N O J EO NG E
ㄴㅗㄹㅇㅣㅂㅏㅇㅇㅣㄴㅏ	N O R I B A NG I N A
ㄴㅗㅇㅅㅏㄴㅁㅜㄹㅇㅔㅅㅓ	N O NG S A N M U R E S EO
ㄴㅗㅍㅇㅡㄴ	N O Ph EU N
ㄴㅗㅅㅓㄴ	N O S EO N
ㄴㅗㄷㅗㅇㅘ	N O D O oA
ㄴㅠㅁㅓㄴ	N iU M EO N
ㅇㅚㅊㅕㄷㅐㅁㅕ	OE CHh iEO D AE M iEO
ㅇㅚㄱㅛㄱㅗㅇㅅㅔㅇㅘ	OE G iO G O NG S E oA
ㅇㅗㄱㅐㄴㅕㄴ	O G AE N iEO N
ㅇㅗㄹㄹㅏㅆㄷㅏㄱㅗ	O L L A t DD A G O
ㅇㅗㄴㅕㄴㅇㅣ	O N iEO N I
ㅇㅗㄹㅣㅇㅗㄴㅍㅡㄹㅣㅌㅗㄹㅔㅇㅣㄱㅏ	O R I O N Ph EU R I Th O R E I G A
ㅇㅗㅅㅣㅂㄷㅐ	O S I p DD AE
ㅂㅐㅊㅣㅎㅏㄴㅡㄴ	B AE CHh I A N EU N
ㅂㅐㄱㅅㅏㅁㅅㅣㅂㄱㅜㅅㅓㄱ	B AE k SS A M S I p GG U S EO k
ㅂㅏㄱㅈㅗㅇㄱㅠㅆㅣㄱㅏ	B A k JJ O NG G iU SS I G A
ㅂㅏㄹㅈㅓㄴㅇㅣㄴㅏ	B A L J EO N I N A
ㅂㅏㄹㅋㅏㄴㄱㅜㄱㄱㅏㄷㅡㄹ	B A L Kh A N G U k GG A D EU L
ㅂㅏㄹㅍㅛㄷㅙㅆㄷㅏ	B A L Ph iO D O AE t DD A
ㅂㅏㄴㅡㄹㄱㅜㅁㅓㅇ	B A N EU L G U M EO NG
ㅂㅏㅇㅁㅣㄹㅡㄹ	B A NG M I R EU L
ㅂㅏㅇㅇㅟㄱㅜㄴ	B A NG UE G U N
ㅂㅏㄴㅂㅏㄹㅇㅣ	B A N B A R I
ㅂㅏㄴㄷㅏㄹㅏㄴㅏㅇㅣㅋㅔ	B A N D A R A N A I Kh E
ㅂㅏㄹㅡㄱㅔㅅㅏㄹㄱㅣ	B A R EU G E S A L G I
ㅂㅏㄷㄱㅣㄴㅡㄴㅋㅓㄴㅕㅇ	B A t GG I N EU N Kh EO N iEO NG
ㅂㅓㄹㅇㅣㄷㅏ	B EO R I D A
ㅂㅓㄴㅇㅕㅇㅇㅡㄹ	B EO N iEO NG EU L
ㅂㅓㅂㅇㅝㄴㅇㅔㅅㅓ	B EO B uEO N E S EO
ㅂㅡㄹㅐㄴㄷㅡㄱㅏ	B EU R AE N D EU G A
ㅍㅐㅅㅕㄴㅇㅠㅌㅗㅇㅂㅜㅂㅜㄴㅇㅔㅅㅓ	Ph AE S iEO N iU Th O NG B U B U N E S EO
ㅍㅏㄹㅂㅐㄱㅇㅣㅅㅣㅂㅇㅝㄴㅅㅓㄴㅇㅡㄹ	Ph A L B AE G I S I B uEO N S EO N EU L
ㅍㅏㄹㅅㅣㅂㅇㅕㄱㅐㄴㅏ	Ph A L S I B iEO G AE N A
ㅍㅏㄴㅁㅐㅇㅘ	Ph A N M AE oA
ㅍㅏㅇㅝㅇㅔㄹㄹㅣㅌㅡㄷㅡㄹㄱㅘㄴㅡㄴ	Ph A uEO E L L I Th EU D EU L G oA N EU N
ㅍㅡㄹㅣㅂㅡㅋㅔㄹㅡㄹ	Ph EU R I B EU Kh E R EU L
ㅍㅣㄹㄹㅏㄷㅔㄹㅍㅣㅇㅏㅇㅔㅅㅓㄴㅡㄴ	Ph I L L A D E L Ph I A E S EO N EU N
ㅍㅣㅅㅓㄴㄱㅓㄱㅝㄴㅇㅡㄹ	Ph I S EO N G EO G uEO N EU L
ㅍㅗㄱㄱㅕㄱㄱㅘ	Ph O k GG iEO k GG oA
ㅍㅗㄹㄹㅣㅌㅔㅋㅡㄴㅣㄱㅇㅡㄴ	Ph O L L I Th E Kh EU N I G EU N
ㅍㅜㅁㅁㅗㄱㅂㅕㄹㄹㅗㄴㅡㄴ	Ph U M M O k BB iEO L L O N EU N
ㅍㅕㅇㅎㅏㅁㅕㄴㅅㅓ	Ph iEO NG H A M iEO N S EO
ㅍㅕㅇㅅㅐㅇㄷㅗㅇㅇㅏㄴ	Ph iEO NG S AE NG D O NG A N
ㅍㅛㅎㅕㄴㅇㅣㄷㅏ	Ph iO iEO N I D A
ㅂㅣㅈㅇㅓㅆㄷㅓㄴ	B I J EO t DD EO N
ㅂㅣㄱㅘㄴㅈㅓㄱㅇㅣㄴ	B I G oA N J EO G I N
ㅂㅣㄴㅂㅓㄴㅎㅣ	B I N B EO N I
ㅂㅣㅅㅓㄱㅘㄴㄷㅡㄹㅇㅔㄱㅔ	B I S EO G oA N D EU R E G E
ㅂㅗㅇㅏㅆㅇㅡㅁㅕ	B O A SS EU M iEO
ㅂㅗㅎㅗㅇㅟㅈㅜ	B O O UE J U
ㅂㅗㄱㄱㅝㄴㅇㅜㄴㅅㅗㅇ	B O k GG uEO N U N S O NG
ㅂㅗㄴㅈㅣㄹㅈㅓㄱㅇㅡㄹㅗ	B O N J I L J EO G EU R O
ㅂㅗㄴㄷㅏㄴㅡㄴ	B O N D A N EU N
ㅂㅗㅅㅜㄹㅗㅇㅢ	B O S U R O euI
ㅃㅏㅈㅕㄴㅏㄱㅏㄹㅕㄷㅓㄴ	BB A J iEO N A G A R iEO D EO N
ㅃㅜㄹㅣㄴㅡㄴ	BB U R I N EU N
ㅂㅜㅊㅣㄴㅡㄴ	B U CHh I N EU N
ㅂㅜㄱㅇㅏㅇㅣㄹㄹㅐㄴㄷㅡㅇㅣㄴㄷㅡㄹㅇㅢ	B U G A I L L AE N D EU I N D EU R euI
ㅂㅜㄱㅂㅜㅈㅣㅇㅕㄱㅇㅔ	B U k BB U J I iEO G E
ㅂㅜㄹㄱㅏㅍㅣㅎㅏㄱㅔ	B U L G A Ph I A G E
ㅂㅜㄹㅂㅓㅂㅌㅜㄱㅣㅇㅘ	B U L B EO p Th U G I oA
ㅂㅜㅁㅜㄴ	B U M U N
ㅂㅜㄴㄹㅣㅎㅏㄴㅡㄴ	B U N N I A N EU N
ㅂㅜㅍㅐ	B U Ph AE
ㅂㅜㅅㅓㅊㅜㄱㅅㅗ	B U S EO CHh U k SS O
ㅂㅜㅌㅇㅣㄱㅗ	B U Th I G O
ㅂㅕㄹㄷㅗㄹㅗ	B iEO L D O R O
ㅂㅕㄴㅎㅘㄷㅗ	B iEO N oA D O
ㄹㅔㅈㅓ	R E J EO
ㄹㅡㅇㅘㄴㄷㅏ	R EU oA N D A
ㄹㅗㅁㅏㄹㅗ	R O M A R O
ㅅㅏㅈㅓㄱㅇㅡㄹㅗ	S A J EO G EU R O
ㅅㅐㄱㄱㅏㅁㅇㅢ	S AE k GG A M euI
ㅅㅐㅇㄱㅏㄱㅎㅏㄴㄷㅏ	S AE NG G A Kh A N D A
ㅅㅐㅇㅅㅏㄴㄹㅏㅇㅣㄴㅇㅡㄹ	S AE NG S A N N A I N EU L
ㅅㅐㄹㅗㅇㅜㄴ	S AE R O U N
ㅅㅏㅎㅚㅁㅜㄴㅎㅘㅈㅓㄱ	S A OE M U N oA J EO k
ㅅㅏㄱㅓㄴㅊㅓㄹㅣㄹㅡㄹ	S A G EO N CHh EO R I R EU L
ㅅㅏㄹㄱㅣㄹㅗ	S A L G I R O
ㅅㅏㅁㅊㅓㄴㅁㅕㅇㅇㅢ	S A M CHh EO N M iEO NG euI
ㅅㅏㅁㅁㅏㄴㅍㅕㅇ	S A M M A N Ph iEO NG
ㅅㅏㅁㅅㅏㅁㅎㅓㄴㅂㅕㅇㄷㅐ	S A M S A M H EO N B iEO NG D AE
ㅅㅏㅁㅅㅣㅂㅅㅏㅁㅈㅓㅁㄱㅜ	S A M S I p SS A M J EO M G U
ㅅㅏㄴㅇㅓㅂㅈㅏㄱㅡㅁㄷㅐㅊㅜㄹㅂㅣㄹㅣ	S A N EO p JJ A G EU M D AE CHh U L B I R I
ㅅㅏㅇㅎㅏㄴㅡㄴ	S A NG H A N EU N
ㅅㅏㅇㅂㅏㄴㄱㅣㅇㅔㄴㅡㄴ	S A NG B A N G I E N EU N
ㅅㅏㅇㅅㅜㄷㅗㅂㅗㄱㅡㅂㄹㅠㄹㅇㅡㄹ	S A NG S U D O B O G EU M N iU R EU L
ㅅㅏㄴㅅㅓㅇㅎㅘㄱㅏ	S A N S EO NG H oA G A
ㅅㅏㄹㅏㅁㅇㅔ	S A R A M E
ㅅㅏㅅㅣ	S A S I
ㅅㅏㅌㅐㅇㅔㅅㅓㄷㅗ	S A Th AE E S EO D O
ㅅㅔㅈㅔㅇㅘ	S E J E oA
ㅅㅔㄱㅖㄱㅛㅎㅚㅎㅕㅂㅇㅢㅎㅚ	S E G iE G iO OE iEO B euI OE
ㅅㅓㄱㅅㅏㅎㅏㄱㅇㅟㄹㅡㄹ	S EO k SS A A G UE R EU L
ㅅㅓㄹㄴㅏㄹ	S EO N N A L
ㅅㅓㄴㅊㅜㄹㅂㅏㅇㅅㅣㄱ	S EO N CHh U L B A NG S I k
ㅅㅓㅇㅎㅐㅇㅎㅏㄴㅡㄴ	S EO NG H AE NG H A N EU N
ㅅㅓㅇㅍㅗㄱㅎㅐㅇ	S EO NG Ph O Kh AE NG
ㅅㅓㄴㄱㅓㄱㅜㅂㅕㄹ	S EO N G EO G U B iEO L
ㅅㅓㄴㅁㅜㄹㅇㅢ	S EO N M U R euI
ㅅㅓㄴㄷㅜㄹㅡㄹ	S EO N D U R EU L
ㅅㅓㅇㅜㄹㅈㅓㄴㄱㅣㅅㅏㄴㅇㅓㅂㅇㅡㄴ	S EO U L J EO N G I S A N EO B EU N
ㅅㅔㄹㅡㅂㅣㅇㅏㄱㅖㅇㅢ	S E R EU B I A G iE euI
ㅅㅡㄹㄹㅣㅁㅎㅘㄹㅡㄹ	S EU L L I M H oA R EU L
ㅅㅡㅍㅔㅇㅣㄴㅇㅣㄴㄷㅡㄹㅇㅡㄴ	S EU Ph E I N I N D EU R EU N
ㅅㅔㅇㅠㄹㄷㅗ	S E iU L D O
ㅅㅣㅈㅏㅇㄱㅕㅇㅈㅔㄴㅡㄴ	S I J A NG G iEO NG J E N EU N
ㅅㅣㅎㅐㅇㄱㅘㅈㅓㅇㅇㅢ	S I AE NG G oA J EO NG euI
ㅅㅣㅋㅣㄱㅣ	S I Kh I G I
ㅅㅣㄱㅜㄱㅅㅓㄴㅇㅓㄴㄱㅘ	S I G U k SS EO N EO N G oA
ㅅㅣㄹㅇㅓㄴㅇㅡㄹ	S I R EO N EU L
ㅅㅣㄹㅁㅏㅇㅇㅡㄴ	S I L M A NG EU N
ㅅㅣㄹㅅㅣㅎㅐㅇㅗㄴ	S I L S I AE O N
ㅅㅣㅁㅣㄴㅅㅏㅎㅚㄷㅗ	S I M I N S A OE D O
ㅅㅣㅁㅇㅢㄹㅡㄹ	S I M euI R EU L
ㅅㅣㄴㅎㅏㅇㅁㅏㄴ	S I N A NG M A N
ㅅㅣㄴㅁㅣㄴㄷㅏㅇ	S I N M I N D A NG
ㅅㅣㄴㅅㅔㅇㅕㅆㄷㅏ	S I N S E iEO t DD A
ㅅㅣㅍㅇㅡㅁㅕㄴ	S I Ph EU M iEO N
ㅅㅣㅂㅇㅗㅈㅓㅁㅊㅣㄹㅇㅗㄷㅏㄹㄹㅓㄹㅗ	S I B O J EO M CHh I R O D A L L EO R O
ㅅㅣㅂㅅㅜㅁㅕㅇㅇㅢ	S I p SS U M iEO NG euI
ㅅㅣㄷㅐㅇㅔ	S I D AE E
ㅅㅗㅈㅐㄹㅗ	S O J AE R O
ㅅㅗㄱㅡㄱㅈㅓㄱㅇㅣㄴ	S O G EU k JJ EO G I N
ㅅㅗㅇㅊㅓㄹㅇㅝㄴ	S O NG CHh EO R uEO N
ㅅㅗㅂㅣㅁㅜㄴㅎㅘㅇㅢ	S O B I M U N oA euI
ㅅㅗㅅㅜㅁㅣㄴㅈㅗㄱㅇㅢ	S O S U M I N J O G euI
ㅆㅏㄹㅎㅕㅂㅅㅏㅇㄱㅘ	SS A R H iEO p SS A NG G oA
ㅆㅡㄹㅔㄱㅣㅁㅐㄹㅣㅂㅈㅏㅇ	SS EU R E G I M AE R I p JJ A NG
ㅅㅜㅈㅓㅇㅎㅏㄹ	S U J EO NG H A L
ㅅㅜㅈㅜㄴㅇㅡㄹ	S U J U N EU L
ㅅㅜㅇㅣㅂㄱㅘ	S U I p GG oA
ㅅㅜㅁㄱㅕㅈㅕ	S U M G iEO J iEO
ㅅㅜㅂㅣㅅㅜㄹㅗ	S U B I S U R O
ㅅㅜㅅㅡㅂㅎㅐㄱㅏㅁㅕ	S U S EU Ph AE G A M iEO
ㅅㅙㅅㅣㄴㅎㅐㅇㅑ	S O AE S I N AE iA
ㄷㅐㅉㅗㄱ	D AE JJ O k
ㄷㅐㅈㅜㅇㅁㅜㄴㅎㅘㅇㅔ	D AE J U NG M U N oA E
ㄷㅐㅎㅚㄴㅡㄴ	D AE OE N EU N
ㄷㅐㄱㅝㄴㅈㅓㄴㄹㅑㄱㅇㅔ	D AE G uEO N J EO N N iA G E
ㄷㅐㅍㅗㄱㅂㅗㅇㅘㄴㅎㅏㄴ	D AE Ph O k BB O oA N A N
ㄷㅐㄹㅣㅂㅇㅡㄹㅗ	D AE R I B EU R O
ㄷㅐㄷㅏㄴㅎㅏㄷㅏ	D AE D A N A D A
ㄷㅏㅇㅡㅁㅂㅓㄴㅇㅔㄴㅡㄴ	D A EU M B EO N E N EU N
ㄷㅏㄹㅈㅏㄴㅡㄴ	D A L J A N EU N
ㄷㅏㅁㄱㅕㅈㅣㄴ	D A M G iEO J I N
ㄷㅏㅇㅊㅗㅇㅏㄴㅂㅗㄷㅏ	D A NG CHh O A N B O D A
ㄷㅏㅇㅂㅣㅅㅓㄱㅏ	D A NG B I S EO G A
ㄷㅏㄴㅎㅐㅇㅎㅏㄹㅏㄴㅡㄴ	D A N AE NG H A R A N EU N
ㄷㅏㄴㅇㅟㅇㅔ	D A N UE E
ㄷㅏㅅㅓㅅㅅㅣㅂㅜㅌㅓ	D A S EO S SS I B U Th EO
ㄷㅓㅁㅗㄷㅡ	D EO M O D EU
ㄷㅡㄹㅇㅓㄱㅏㄴㄷㅏㄱㅗ	D EU R EO G A N D A G O
ㄷㅡㅁㅜㄴ	D EU M U N
ㄷㅡㄹㅓㄴㅏㅆㄴㅡㄴㄷㅔㄷㅗ	D EU R EO N A N N EU N D E D O
ㅌㅐㄷㅗㄹㅗ	Th AE D O R O
ㅌㅏㅁㅅㅐㄱㅇㅕㄴㄱㅜㅌㅣㅁㅇㅣ	Th A M S AE G iEO N G U Th I M I
ㅌㅔㅁㅏㅍㅏㅋㅡ	Th E M A Ph A Kh EU
ㅌㅡㄱㅈㅣㅇ	Th EU k JJ I NG
ㅌㅡㄹㄹㅣㅁㅇㅓㅄㅇㅓ	Th EU L L I M EO p SS EO
ㅌㅚㅎㅐㅇㅇㅡㄹ	Th OE AE NG EU L
ㅌㅗㅇㅎㅏㅂㄹㅗㄴㅈㅏㄷㅡㄹㅇㅢ	Th O NG H A M N O N J A D EU R euI
ㅌㅗㅇㄱㅘㄹㅡㄹ	Th O NG G oA R EU L
ㅌㅗㅅㅏㄴㅍㅜㅁ	Th O S A N Ph U M
ㅌㅜㅊㅣㅇㅕㅅㅓㅇㄷㅡㄹㅇㅔ	Th U CHh I iEO S EO NG D EU R E
ㄷㅣㅇㅔㅇㅣㅇㅔㅅㅡㅇㅔㅇㅣㅇㅔㄱㅔㄴㅡㄴ	D I E I E S EU E I E G E N EU N
ㄷㅚㄱㅣㄲㅏㅈㅣ	D OE G I GG A J I
ㄷㅗㅇㅣㅂㄱㅘ	D O I p GG oA
ㄷㅗㄱㄱㅘㅈㅓㅁㅅㅣㅈㅏㅇㄱㅜㅈㅗㄹㅡㄹ	D O k GG oA J EO M S I J A NG G U J O R EU L
ㄷㅗㄹㄱㅕㄱㄷㅐㄷㅡㄹㅇㅡㄴ	D O L G iEO k DD AE D EU R EU N
ㄷㅗㅇㅉㅗㄱㅈㅣㅂㅏㅇㅇㅔㅅㅓ	D O NG JJ O k JJ I B A NG E S EO
ㄷㅗㅇㄱㅛㄷㅗㅇㅉㅗㄱ	D O NG G iO D O NG JJ O k
ㄷㅗㅇㅇㅝㄴㅎㅏㄹ	D O NG uEO N A L
ㄷㅗㅅㅣㅇㅔ	D O S I E
ㄸㅏㅈㅕㅆㄷㅏㄴㅡㄴ	DD A J iEO t DD A N EU N
ㄸㅏㄹㅏㅈㅜㅇㅓㅇㅑ	DD A R A J U EO iA
ㄸㅓㄷㅗㄹㅇㅏㅆㄷㅏ	DD EO D O R A t DD A
ㄷㅜㅊㅏㄹㅖㄴㅏ	D U CHh A R iE N A
ㄷㅜㄹㅕㅇㅝㅎㅏㅇㅕ	D U R iEO uEO A iEO
ㄷㅟㅅㅈㅓㄴㅇㅡㄹㅗ	D UE t JJ EO N EU R O
ㅇㅜㅁㅈㅣㄱㅇㅣㅁㅇㅔ	U M J I G I M E
ㅇㅜㄴㅇㅕㅇㅂㅣㄹㅡㄹ	U N iEO NG B I R EU L
ㅇㅜㄹㅣㅇㅘ	U R I oA
ㅇㅙㅋㅡㄴㅎㅓㅅㅅㅏㅇㅢ	O AE Kh EU N EO S SS A euI
ㅇㅘㄴㅂㅗㅇㅅㅡㅇㅇㅡㄹ	oA N B O NG S EU NG EU L
ㅇㅝㄴㅊㅓㄴㅈㅣㅇㅅㅜㅇㅕㅂㅜ	uEO N CHh EO N J I NG S U iEO B U
ㅇㅝㄴㄴㅕㄴㅇㅡㄹㅗ	uEO N N iEO N EU R O
ㅇㅟㅎㅐ	UE AE
ㅇㅟㅍㅐㄱㅏ	UE Ph AE G A
ㅇㅑㄱㅈㅓㅁㅇㅔㄷㅗ	iA k JJ EO M E D O
ㅇㅑㄹㄹㅑㄴㅡㄴ	iA L L iA N EU N
ㅇㅑㅇㅇㅑㅇㅇㅣㄹㅏㄴ	iA NG iA NG I R A N
ㅇㅖㄱㅡㅁㄱㅡㅁㄹㅣ	iE G EU M G EU M N I
ㅇㅕㄱㅎㅏㄱㄱㅘㄴㄱㅖㅇㅘ	iEO Kh A k GG oA N G iE oA
ㅇㅕㄱㅕㅈㅣㄱㅗ	iEO G iEO J I G O
ㅇㅕㄹㅅㅚㄷㅏ	iEO L S OE D A
ㅇㅕㅇㅎㅗㄴㅇㅣ	iEO NG H O N I
ㅇㅕㅇㄴㅐ	iEO NG N AE
ㅇㅕㄴㅎㅠㄱㅏ	iEO N iU G A
ㅇㅕㄴㅁㅕㅇㅎㅏㅇㅕ	iEO N M iEO NG H A iEO
ㅇㅕㄴㄷㅐㅇㅢ	iEO N D AE euI
ㅇㅕㅅㅓㅅㅍㅕㅇ	iEO S EO t Ph iEO NG
ㅇㅖㅅㅏㅇㅎㅐㅆㄷㅓㄴ	iE S A NG H AE t DD EO N
ㅇㅢㅈㅗㄴㅎㅏㅁㅕㄴㅅㅓ	euI J O N A M iEO N S EO
ㅇㅢㄹㅖㅇㅔ	euI R iE E
ㅇㅢㅇㅛㄱㅈㅓㄱㅇㅣㄷㅏ	euI iO k JJ EO G I D A
ㅇㅛㄱㅜㄷㅚㅈㅣ	iO G U D OE J I
ㅇㅠㅇㅏㅅㅜㄷㅏㅇ	iU A S U D A NG
ㅇㅠㅎㅗㄱㅇㅔ	iU O G E
ㅇㅠㄱㄱㅜㄴㅂㅗㄴㅂㅜ	iU k GG U N B O N B U
ㅇㅠㄱㅅㅣㅂㅇㅗㅋㅣㄹㄹㅗㅁㅣㅌㅓㅇㅢ	iU k SS I B O Kh I L L O M I Th EO euI
ㅇㅠㄴㅆㅣㄴㅡㄴ	iU N SS I N EU N
ㅇㅠㅅㅜㅇㅏㅁㄹㅣㄹㅗ	iU S U A M N I R O
ㅇㅠㅇㅑㅁㅜㅇㅑㄷㅚㄴ	iU iA M U iA D OE N
